Season,DayNum,TeamIdA,ScoreA,TeamIdB,ScoreB,SeedA,SeedB,WinRatioA,GapAvgA,WinRatioB,GapAvgB,SeedDiff,WinRatioDiff,GapAvgDiff,ScoreDiff,WinA
2016,137,3107,61,3196,59,12,5,0.8709677419354839,18.677419354838708,0.7333333333333333,8.7,7,0.1376344086021506,9.977419354838709,2,1
2016,137,3113,74,3308,52,2,15,0.8064516129032258,9.258064516129032,0.8571428571428571,8.964285714285714,-13,-0.05069124423963134,0.2937788018433185,22,1
2016,137,3120,68,3385,57,9,8,0.6129032258064516,3.032258064516129,0.71875,6.8125,1,-0.10584677419354838,-3.780241935483871,11,1
2016,137,3124,89,3225,59,1,16,0.9705882352941176,24.61764705882353,0.7096774193548387,10.61290322580645,-15,0.2609108159392789,14.004743833017079,30,1
2016,137,3177,97,3241,67,6,11,0.7575757575757576,16.272727272727273,0.84375,15.40625,-5,-0.08617424242424243,0.8664772727272734,30,1
2016,137,3243,56,3203,51,9,8,0.6,3.933333333333333,0.8125,9.65625,1,-0.21250000000000002,-5.722916666666666,5,1
2016,137,3257,87,3146,60,3,14,0.78125,12.718749999999998,0.8888888888888888,9.11111111111111,-11,-0.10763888888888884,3.6076388888888875,27,1
2016,137,3277,74,3125,60,4,13,0.75,11.8125,0.7333333333333333,10.26666666666667,-9,0.01666666666666672,1.5458333333333307,14,1
2016,137,3280,60,3151,50,5,12,0.7878787878787878,15.93939393939394,0.7741935483870968,5.32258064516129,-7,0.013685239491691092,10.61681329423265,10,1
2016,137,3326,88,3138,69,3,14,0.7741935483870968,12.258064516129032,0.6060606060606061,1.0606060606060606,-11,0.16813294232649068,11.197458455522971,19,1
2016,137,3333,73,3407,31,2,15,0.875,15.5,0.6,3.033333333333333,-13,0.275,12.466666666666667,42,1
2016,137,3376,77,3239,41,1,16,0.96875,17.90625,0.6666666666666666,10.0,-15,0.30208333333333337,7.90625,36,1
2016,137,3382,65,3329,54,10,7,0.7666666666666667,7.966666666666667,0.7,7.6,3,0.06666666666666676,0.36666666666666714,11,1
2016,137,3393,73,3119,56,4,13,0.78125,13.0,0.9333333333333333,20.066666666666666,-9,-0.15208333333333335,-7.066666666666666,17,1
2016,137,3397,59,3453,53,7,10,0.59375,7.0625,0.875,14.625,-3,-0.28125,-7.5625,6,1
2016,137,3452,74,3343,65,6,11,0.7272727272727273,12.545454545454545,0.8214285714285714,18.25,-5,-0.0941558441558441,-5.704545454545455,9,1
2016,138,3163,101,3352,49,1,16,1.0,39.6875,0.6129032258064516,3.806451612903226,-15,0.3870967741935484,35.881048387096776,52,1
2016,138,3182,97,3371,76,9,8,0.8387096774193549,10.548387096774194,0.7419354838709677,7.354838709677419,1,0.09677419354838712,3.193548387096775,21,1
2016,138,3199,72,3292,55,5,12,0.7666666666666667,17.066666666666666,0.75,8.8125,-7,0.01666666666666672,8.254166666666666,17,1
2016,138,3231,62,3208,58,9,8,0.6451612903225806,4.225806451612903,0.7,10.266666666666667,1,-0.05483870967741933,-6.0408602150537645,4,1
2016,138,3246,85,3421,31,3,14,0.7666666666666667,13.433333333333332,0.8,8.833333333333334,-11,-0.033333333333333326,4.599999999999998,54,1
2016,138,3268,74,3233,58,2,15,0.9090909090909091,24.03030303030303,0.6764705882352942,5.970588235294118,-13,0.2326203208556149,18.059714795008915,16,1
2016,138,3281,78,3140,69,10,7,0.7,10.5,0.8064516129032258,6.903225806451613,3,-0.1064516129032258,3.596774193548387,9,1
2016,138,3323,95,3299,61,1,16,0.96875,19.125,0.6071428571428571,4.107142857142857,-15,0.3616071428571429,15.017857142857142,34,1
2016,138,3328,61,3345,45,6,11,0.6774193548387096,8.32258064516129,0.6451612903225806,6.516129032258065,-5,0.032258064516129004,1.806451612903225,16,1
2016,138,3355,74,3274,71,12,5,0.8125,10.8125,0.75,10.4375,7,0.0625,0.375,3,1
2016,138,3378,48,3161,45,6,11,0.71875,11.40625,0.9666666666666667,15.666666666666668,-5,-0.24791666666666667,-4.260416666666668,3,1
2016,138,3390,85,3362,58,4,13,0.7741935483870968,13.67741935483871,0.6333333333333333,3.0000000000000004,-9,0.14086021505376345,10.67741935483871,27,1
2016,138,3400,86,3106,42,2,15,0.875,15.0,0.6206896551724138,4.0,-13,0.2543103448275862,11.0,44,1
2016,138,3401,74,3283,65,4,13,0.7,9.8,0.71875,7.375,-9,-0.018750000000000044,2.4250000000000007,9,1
2016,138,3417,66,3218,50,3,14,0.75,10.34375,0.6774193548387096,5.935483870967742,-11,0.07258064516129037,4.408266129032258,16,1
2016,138,3449,65,3335,53,7,10,0.6875,8.78125,0.8518518518518519,10.518518518518519,-3,-0.16435185185185186,-1.737268518518519,12,1
2016,139,3124,84,3120,52,1,9,0.9705882352941176,24.61764705882353,0.6129032258064516,3.032258064516129,-8,0.357685009487666,21.5853889943074,32,1
2016,139,3177,73,3257,72,6,3,0.7575757575757576,16.272727272727273,0.78125,12.718749999999998,3,-0.02367424242424243,3.553977272727275,1,1
2016,139,3280,74,3277,72,5,4,0.7878787878787878,15.93939393939394,0.75,11.8125,1,0.037878787878787845,4.1268939393939394,2,1
2016,139,3326,88,3452,81,3,6,0.7741935483870968,12.258064516129032,0.7272727272727273,12.545454545454545,-3,0.04692082111436946,-0.28739002932551294,7,1
2016,139,3333,69,3382,40,2,10,0.875,15.5,0.7666666666666667,7.966666666666667,-8,0.10833333333333328,7.533333333333333,29,1
2016,139,3376,73,3243,47,1,9,0.96875,17.90625,0.6,3.933333333333333,-8,0.36875,13.972916666666666,26,1
2016,139,3393,76,3107,59,4,12,0.78125,13.0,0.8709677419354839,18.677419354838708,-8,-0.08971774193548387,-5.677419354838708,17,1
2016,139,3397,75,3113,64,7,2,0.59375,7.0625,0.8064516129032258,9.258064516129032,5,-0.21270161290322576,-2.195564516129032,11,1
2016,140,3163,97,3182,51,1,9,1.0,39.6875,0.8387096774193549,10.548387096774194,-8,0.16129032258064513,29.139112903225808,46,1
2016,140,3199,74,3401,56,5,4,0.7666666666666667,17.066666666666666,0.7,9.8,1,0.06666666666666676,7.266666666666666,18,1
2016,140,3246,79,3328,58,3,6,0.7666666666666667,13.433333333333332,0.6774193548387096,8.32258064516129,-3,0.08924731182795709,5.110752688172042,21,1
2016,140,3323,87,3231,70,1,9,0.96875,19.125,0.6451612903225806,4.225806451612903,-8,0.3235887096774194,14.899193548387096,17,1
2016,140,3390,66,3355,65,4,12,0.7741935483870968,13.67741935483871,0.8125,10.8125,-8,-0.03830645161290325,2.86491935483871,1,1
2016,140,3400,73,3281,55,2,10,0.875,15.0,0.7,10.5,-8,0.17500000000000004,4.5,18,1
2016,140,3417,72,3378,67,3,6,0.75,10.34375,0.71875,11.40625,-3,0.03125,-1.0625,5,1
2016,140,3449,74,3268,65,7,2,0.6875,8.78125,0.9090909090909091,24.03030303030303,5,-0.22159090909090906,-15.249053030303031,9,1
2016,144,3390,90,3323,84,4,1,0.7741935483870968,13.67741935483871,0.96875,19.125,3,-0.19455645161290325,-5.44758064516129,6,1
2016,144,3393,80,3376,72,4,1,0.78125,13.0,0.96875,17.90625,3,-0.1875,-4.90625,8,1
2016,144,3397,78,3326,62,7,3,0.59375,7.0625,0.7741935483870968,12.258064516129032,4,-0.18044354838709675,-5.195564516129032,16,1
2016,144,3449,85,3246,72,7,3,0.6875,8.78125,0.7666666666666667,13.433333333333332,4,-0.07916666666666672,-4.652083333333332,13,1
2016,145,3124,78,3199,58,1,5,0.9705882352941176,24.61764705882353,0.7666666666666667,17.066666666666666,-4,0.20392156862745092,7.550980392156863,20,1
2016,145,3163,98,3280,38,1,5,1.0,39.6875,0.7878787878787878,15.93939393939394,-4,0.21212121212121215,23.748106060606062,60,1
2016,145,3333,83,3177,71,2,6,0.875,15.5,0.7575757575757576,16.272727272727273,-4,0.11742424242424243,-0.7727272727272734,12,1
2016,145,3400,72,3417,64,2,3,0.875,15.0,0.75,10.34375,-1,0.125,4.65625,8,1
2016,146,3393,89,3397,67,4,7,0.78125,13.0,0.59375,7.0625,-3,0.1875,5.9375,22,1
2016,146,3449,85,3390,76,7,4,0.6875,8.78125,0.7741935483870968,13.67741935483871,3,-0.08669354838709675,-4.89616935483871,9,1
2016,147,3163,86,3400,65,1,2,1.0,39.6875,0.875,15.0,-1,0.125,24.6875,21,1
2016,147,3333,60,3124,57,2,1,0.875,15.5,0.9705882352941176,24.61764705882353,1,-0.09558823529411764,-9.117647058823529,3,1
2016,153,3163,80,3333,51,1,2,1.0,39.6875,0.875,15.5,-1,0.125,24.1875,29,1
2016,153,3393,80,3449,59,4,7,0.78125,13.0,0.6875,8.78125,-3,0.09375,4.21875,21,1
2016,155,3163,82,3393,51,1,4,1.0,39.6875,0.78125,13.0,-3,0.21875,26.6875,31,1
2017,137,3113,73,3277,61,8,9,0.6129032258064516,6.161290322580645,0.65625,7.03125,-1,-0.043346774193548376,-0.869959677419355,12,1
2017,137,3166,76,3405,49,7,10,0.7666666666666667,8.066666666666666,0.75,8.28125,-3,0.01666666666666672,-0.21458333333333357,27,1
2017,137,3177,88,3320,67,7,10,0.7878787878787878,13.727272727272727,0.7419354838709677,9.387096774193548,-3,0.045943304007820096,4.340175953079179,21,1
2017,137,3199,87,3442,66,3,14,0.8064516129032258,21.806451612903224,0.8,9.8,-11,0.006451612903225712,12.006451612903223,21,1
2017,137,3246,73,3125,70,4,13,0.6774193548387096,8.193548387096774,0.8387096774193549,12.096774193548388,-9,-0.16129032258064524,-3.903225806451614,3,1
2017,137,3268,103,3137,61,3,14,0.9375,25.4375,0.84375,9.9375,-11,0.09375,15.5,42,1
2017,137,3280,110,3407,69,2,15,0.8787878787878788,19.454545454545453,0.6666666666666666,8.266666666666667,-13,0.21212121212121215,11.187878787878786,41,1
2017,137,3281,66,3378,64,6,11,0.6774193548387096,4.645161290322581,0.75,9.3125,-5,-0.07258064516129037,-4.667338709677419,2,1
2017,137,3301,62,3120,48,6,11,0.7333333333333333,12.466666666666665,0.5483870967741935,2.225806451612903,-5,0.18494623655913978,10.240860215053761,14,1
2017,137,3323,79,3352,49,1,16,0.9090909090909091,18.21212121212121,0.6774193548387096,6.645161290322581,-15,0.23167155425219943,11.566959921798631,30,1
2017,137,3326,70,3443,63,5,12,0.8125,15.5625,0.8181818181818182,13.757575757575756,-7,-0.005681818181818232,1.804924242424244,7,1
2017,137,3333,56,3253,55,2,15,0.8787878787878788,12.272727272727273,0.6875,2.46875,-13,0.19128787878787878,9.803977272727273,1,1
2017,137,3345,74,3453,62,9,8,0.6470588235294118,7.823529411764706,0.84375,18.65625,1,-0.1966911764705882,-10.832720588235293,12,1
2017,137,3376,90,3421,40,1,16,0.8709677419354839,19.258064516129032,0.5625,2.3125,-15,0.3084677419354839,16.945564516129032,50,1
2017,137,3400,78,3146,50,3,14,0.7419354838709677,12.35483870967742,0.8461538461538461,11.73076923076923,-11,-0.1042183622828784,0.62406947890819,28,1
2017,137,3452,75,3189,62,6,11,0.696969696969697,12.545454545454545,0.8125,11.21875,-5,-0.11553030303030298,1.326704545454545,13,1
2017,138,3124,119,3411,30,1,16,0.9090909090909091,32.57575757575758,0.7096774193548387,4.645161290322581,-15,0.19941348973607032,27.930596285434998,89,1
2017,138,3143,55,3261,52,9,8,0.59375,5.03125,0.6451612903225806,4.709677419354839,1,-0.05141129032258063,0.32157258064516103,3,1
2017,138,3163,116,3107,55,1,16,1.0,32.8125,0.6451612903225806,3.6451612903225805,-15,0.3548387096774194,29.16733870967742,61,1
2017,138,3181,94,3214,31,2,15,0.84375,17.71875,0.625,2.15625,-13,0.21875,15.5625,63,1
2017,138,3243,67,3179,54,7,10,0.6875,5.59375,0.8709677419354839,16.93548387096774,-3,-0.18346774193548387,-11.34173387096774,13,1
2017,138,3257,82,3151,62,4,13,0.7941176470588235,14.882352941176471,0.6774193548387096,5.645161290322581,-9,0.11669829222011385,9.237191650853891,20,1
2017,138,3274,62,3195,60,4,13,0.7419354838709677,9.645161290322578,0.75,14.4375,-9,-0.008064516129032251,-4.792338709677422,2,1
2017,138,3328,75,3211,62,6,11,0.7096774193548387,5.096774193548387,0.8125,14.5,-5,-0.10282258064516125,-9.403225806451612,13,1
2017,138,3332,71,3396,70,10,7,0.6060606060606061,6.151515151515151,0.7741935483870968,9.580645161290322,3,-0.16813294232649068,-3.4291300097751707,1,1
2017,138,3346,68,3266,65,12,5,0.8181818181818182,11.575757575757578,0.78125,9.0,7,0.03693181818181823,2.575757575757578,3,1
2017,138,3390,72,3308,64,2,15,0.8484848484848485,16.575757575757574,0.7857142857142857,7.928571428571429,-13,0.06277056277056281,8.647186147186146,8,1
2017,138,3393,85,3235,65,8,9,0.6774193548387096,12.35483870967742,0.6,5.833333333333333,-1,0.07741935483870965,6.521505376344087,20,1
2017,138,3397,66,3173,57,5,12,0.6333333333333333,8.0,0.7096774193548387,6.580645161290323,-7,-0.07634408602150544,1.419354838709677,9,1
2017,138,3401,63,3335,61,5,12,0.65625,6.90625,0.75,8.285714285714286,-7,-0.09375,-1.3794642857142865,2,1
2017,138,3417,83,3129,56,4,13,0.7419354838709677,9.935483870967742,0.7666666666666667,5.266666666666667,-9,-0.02473118279569897,4.668817204301075,27,1
2017,138,3449,91,3286,63,3,14,0.84375,21.625,0.7931034482758621,7.068965517241379,-11,0.0506465517241379,14.556034482758621,28,1
2017,139,3199,77,3281,55,3,6,0.8064516129032258,21.806451612903224,0.6774193548387096,4.645161290322581,-3,0.12903225806451613,17.161290322580644,22,1
2017,139,3268,83,3452,56,3,6,0.9375,25.4375,0.696969696969697,12.545454545454545,-3,0.24053030303030298,12.892045454545455,27,1
2017,139,3280,92,3177,71,2,7,0.8787878787878788,19.454545454545453,0.7878787878787878,13.727272727272727,-5,0.09090909090909094,5.727272727272727,21,1
2017,139,3323,88,3345,82,1,9,0.9090909090909091,18.21212121212121,0.6470588235294118,7.823529411764706,-8,0.26203208556149726,10.388591800356505,6,1
2017,139,3326,82,3246,68,5,4,0.8125,15.5625,0.6774193548387096,8.193548387096774,1,0.13508064516129037,7.368951612903226,14,1
2017,139,3333,64,3166,52,2,7,0.8787878787878788,12.272727272727273,0.7666666666666667,8.066666666666666,-5,0.11212121212121207,4.206060606060607,12,1
2017,139,3376,71,3113,68,1,8,0.8709677419354839,19.258064516129032,0.6129032258064516,6.161290322580645,-7,0.25806451612903225,13.096774193548388,3,1
2017,139,3400,84,3301,80,3,6,0.7419354838709677,12.35483870967742,0.7333333333333333,12.466666666666665,-3,0.008602150537634468,-0.11182795698924508,4,1
2017,140,3124,86,3143,46,1,9,0.9090909090909091,32.57575757575758,0.59375,5.03125,-8,0.31534090909090906,27.544507575757578,40,1
2017,140,3163,94,3393,64,1,8,1.0,32.8125,0.6774193548387096,12.35483870967742,-7,0.32258064516129037,20.45766129032258,30,1
2017,140,3257,75,3397,64,4,5,0.7941176470588235,14.882352941176471,0.6333333333333333,8.0,-1,0.16078431372549018,6.882352941176471,11,1
2017,140,3332,74,3181,65,10,2,0.6060606060606061,6.151515151515151,0.84375,17.71875,8,-0.23768939393939392,-11.567234848484848,9,1
2017,140,3346,85,3274,78,12,4,0.8181818181818182,11.575757575757578,0.7419354838709677,9.645161290322578,8,0.07624633431085048,1.9305962854349996,7,1
2017,140,3390,69,3243,48,2,7,0.8484848484848485,16.575757575757574,0.6875,5.59375,-5,0.1609848484848485,10.982007575757574,21,1
2017,140,3417,75,3401,43,4,5,0.7419354838709677,9.935483870967742,0.65625,6.90625,-1,0.08568548387096775,3.029233870967742,32,1
2017,140,3449,108,3328,82,3,6,0.84375,21.625,0.7096774193548387,5.096774193548387,-3,0.13407258064516125,16.528225806451612,26,1
2017,144,3124,97,3257,63,1,4,0.9090909090909091,32.57575757575758,0.7941176470588235,14.882352941176471,-3,0.11497326203208558,17.693404634581107,34,1
2017,144,3280,75,3449,64,2,3,0.8787878787878788,19.454545454545453,0.84375,21.625,-1,0.035037878787878785,-2.1704545454545467,11,1
2017,144,3323,99,3326,76,1,5,0.9090909090909091,18.21212121212121,0.8125,15.5625,-4,0.09659090909090906,2.649621212121211,23,1
2017,144,3390,77,3400,66,2,3,0.8484848484848485,16.575757575757574,0.7419354838709677,12.35483870967742,-1,0.10654936461388076,4.220918866080154,11,1
2017,145,3163,86,3417,71,1,4,1.0,32.8125,0.7419354838709677,9.935483870967742,-3,0.25806451612903225,22.877016129032256,15,1
2017,145,3199,66,3333,53,3,2,0.8064516129032258,21.806451612903224,0.8787878787878788,12.272727272727273,1,-0.07233626588465303,9.53372434017595,13,1
2017,145,3332,77,3268,63,10,3,0.6060606060606061,6.151515151515151,0.9375,25.4375,7,-0.3314393939393939,-19.285984848484848,14,1
2017,145,3376,100,3346,58,1,12,0.8709677419354839,19.258064516129032,0.8181818181818182,11.575757575757578,-11,0.05278592375366564,7.682306940371454,42,1
2017,146,3280,94,3124,85,2,1,0.8787878787878788,19.454545454545453,0.9090909090909091,32.57575757575758,1,-0.030303030303030276,-13.121212121212125,9,1
2017,146,3390,76,3323,75,2,1,0.8484848484848485,16.575757575757574,0.9090909090909091,18.21212121212121,1,-0.06060606060606055,-1.6363636363636367,1,1
2017,147,3163,90,3332,52,1,10,1.0,32.8125,0.6060606060606061,6.151515151515151,-9,0.3939393939393939,26.660984848484848,38,1
2017,147,3376,71,3199,64,1,3,0.8709677419354839,19.258064516129032,0.8064516129032258,21.806451612903224,-2,0.06451612903225812,-2.548387096774192,7,1
2017,151,3280,66,3163,64,2,1,0.8787878787878788,19.454545454545453,1.0,32.8125,1,-0.12121212121212122,-13.357954545454547,2,1
2017,151,3376,62,3390,53,1,2,0.8709677419354839,19.258064516129032,0.8484848484848485,16.575757575757574,-1,0.022482893450635366,2.6823069403714577,9,1
2017,153,3376,67,3280,55,1,2,0.8709677419354839,19.258064516129032,0.8787878787878788,19.454545454545453,-1,-0.00782013685239491,-0.19648093841642122,12,1
2018,137,3124,96,3212,46,2,15,0.96875,30.687500000000004,0.59375,-0.09375,-13,0.375,30.781250000000004,50,1
2018,137,3177,90,3328,79,5,12,0.7878787878787878,12.545454545454545,0.5333333333333333,3.8,-7,0.2545454545454545,8.745454545454546,11,1
2018,137,3257,74,3129,42,1,16,0.9411764705882353,19.647058823529413,0.7,5.8,-15,0.24117647058823533,13.847058823529412,32,1
2018,137,3266,84,3173,65,8,9,0.71875,10.0,0.7931034482758621,12.241379310344827,-1,-0.0743534482758621,-2.2413793103448274,19,1
2018,137,3268,77,3343,57,5,12,0.78125,16.28125,0.8275862068965517,13.655172413793103,-7,-0.04633620689655171,2.626077586206897,20,1
2018,137,3276,75,3294,61,7,10,0.7096774193548387,13.483870967741936,0.8125,6.96875,-3,-0.10282258064516125,6.515120967741936,14,1
2018,137,3278,89,3453,77,10,7,0.7419354838709677,11.290322580645162,0.90625,19.125,3,-0.16431451612903225,-7.834677419354838,12,1
2018,137,3301,62,3189,35,4,13,0.75,9.59375,0.7741935483870968,13.870967741935484,-9,-0.024193548387096753,-4.277217741935484,27,1
2018,137,3323,99,3169,81,1,16,0.90625,18.5625,0.5454545454545454,0.8181818181818182,-15,0.3607954545454546,17.744318181818183,18,1
2018,137,3332,88,3370,45,2,15,0.8823529411764706,18.823529411764707,0.5625,0.96875,-13,0.31985294117647056,17.854779411764707,43,1
2018,137,3333,82,3443,58,6,11,0.7666666666666667,15.5,0.7419354838709677,12.612903225806452,-5,0.02473118279569897,2.887096774193548,24,1
2018,137,3376,63,3299,52,2,15,0.8125,15.53125,0.7241379310344828,5.931034482758621,-13,0.08836206896551724,9.600215517241379,11,1
2018,137,3397,100,3251,60,3,14,0.7741935483870968,13.064516129032258,0.7096774193548387,8.935483870967744,-11,0.06451612903225801,4.129032258064514,40,1
2018,137,3401,89,3179,76,4,13,0.7272727272727273,9.757575757575758,0.78125,13.9375,-9,-0.05397727272727271,-4.179924242424242,13,1
2018,137,3437,81,3355,74,9,8,0.7333333333333333,7.566666666666666,0.8064516129032258,16.838709677419356,1,-0.07311827956989247,-9.27204301075269,7,1
2018,137,3438,68,3143,62,10,7,0.5806451612903226,1.096774193548387,0.6774193548387096,3.3870967741935485,3,-0.09677419354838701,-2.2903225806451615,6,1
2018,138,3113,73,3304,62,7,10,0.6363636363636364,10.909090909090908,0.6774193548387096,5.67741935483871,-3,-0.04105571847507328,5.231671554252198,11,1
2018,138,3138,102,3378,79,11,6,0.84375,13.3125,0.7878787878787878,13.303030303030303,5,0.055871212121212155,0.009469696969697239,23,1
2018,138,3141,78,3261,69,11,6,0.8709677419354839,11.064516129032258,0.6785714285714286,5.178571428571429,5,0.19239631336405527,5.885944700460829,9,1
2018,138,3163,140,3384,52,1,16,1.0,36.90625,0.71875,8.96875,-15,0.28125,27.9375,88,1
2018,138,3166,76,3234,70,11,6,0.6,2.933333333333333,0.7741935483870968,10.32258064516129,5,-0.17419354838709677,-7.3892473118279565,6,1
2018,138,3181,72,3125,58,5,12,0.7333333333333333,12.833333333333334,0.9090909090909091,17.666666666666668,-7,-0.17575757575757578,-4.833333333333334,14,1
2018,138,3195,80,3281,70,12,5,0.8709677419354839,17.29032258064516,0.7741935483870968,9.35483870967742,7,0.09677419354838712,7.93548387096774,10,1
2018,138,3199,91,3114,49,3,14,0.8064516129032258,17.096774193548388,0.71875,7.375,-11,0.08770161290322576,9.721774193548388,42,1
2018,138,3208,68,3273,63,4,13,0.8064516129032258,10.64516129032258,0.9375,16.4375,-9,-0.13104838709677424,-5.79233870967742,5,1
2018,138,3280,95,3311,50,1,16,0.9696969696969697,26.303030303030305,0.5517241379310345,-0.10344827586206896,-15,0.41797283176593525,26.406478578892372,45,1
2018,138,3326,87,3203,45,3,14,0.8181818181818182,13.969696969696969,0.59375,2.5625,-11,0.22443181818181823,11.407196969696969,42,1
2018,138,3329,84,3393,57,9,8,0.6666666666666666,11.033333333333333,0.7333333333333333,7.633333333333334,1,-0.06666666666666665,3.3999999999999995,27,1
2018,138,3346,86,3274,72,9,8,0.84375,14.03125,0.6774193548387096,7.645161290322581,1,0.16633064516129037,6.386088709677419,14,1
2018,138,3390,82,3211,68,4,13,0.6875,6.4375,0.84375,13.65625,-9,-0.15625,-7.21875,14,1
2018,138,3400,83,3263,54,2,15,0.8125,16.96875,0.7,7.4,-13,0.11250000000000004,9.56875,29,1
2018,138,3417,71,3110,60,3,14,0.7741935483870968,12.64516129032258,0.8125,6.9375,-11,-0.03830645161290325,5.70766129032258,11,1
2018,139,3124,80,3276,58,2,7,0.96875,30.687500000000004,0.7096774193548387,13.483870967741936,-5,0.25907258064516125,17.203629032258068,22,1
2018,139,3257,90,3266,72,1,8,0.9411764705882353,19.647058823529413,0.71875,10.0,-7,0.22242647058823528,9.647058823529413,18,1
2018,139,3301,74,3268,60,4,5,0.75,9.59375,0.78125,16.28125,-1,-0.03125,-6.6875,14,1
2018,139,3323,98,3437,72,1,9,0.90625,18.5625,0.7333333333333333,7.566666666666666,-8,0.17291666666666672,10.995833333333334,26,1
2018,139,3332,101,3278,73,2,10,0.8823529411764706,18.823529411764707,0.7419354838709677,11.290322580645162,-8,0.1404174573055028,7.533206831119545,28,1
2018,139,3333,66,3397,59,6,3,0.7666666666666667,15.5,0.7741935483870968,13.064516129032258,3,-0.007526881720430034,2.435483870967742,7,1
2018,139,3376,66,3438,56,2,10,0.8125,15.53125,0.5806451612903226,1.096774193548387,-8,0.23185483870967738,14.434475806451612,10,1
2018,139,3401,80,3177,79,4,5,0.7272727272727273,9.757575757575758,0.7878787878787878,12.545454545454545,-1,-0.06060606060606055,-2.787878787878787,1,1
2018,140,3138,86,3199,65,11,3,0.84375,13.3125,0.8064516129032258,17.096774193548388,8,0.037298387096774244,-3.784274193548388,21,1
2018,140,3141,95,3326,78,11,3,0.8709677419354839,11.064516129032258,0.8181818181818182,13.969696969696969,8,0.05278592375366564,-2.905180840664711,17,1
2018,140,3163,71,3346,46,1,9,1.0,36.90625,0.84375,14.03125,-8,0.15625,22.875,25,1
2018,140,3181,66,3208,40,5,4,0.7333333333333333,12.833333333333334,0.8064516129032258,10.64516129032258,1,-0.07311827956989247,2.188172043010754,26,1
2018,140,3280,71,3329,56,1,9,0.9696969696969697,26.303030303030305,0.6666666666666666,11.033333333333333,-8,0.3030303030303031,15.269696969696971,15,1
2018,140,3390,90,3195,70,4,12,0.6875,6.4375,0.8709677419354839,17.29032258064516,-8,-0.18346774193548387,-10.85282258064516,20,1
2018,140,3400,85,3113,65,2,7,0.8125,16.96875,0.6363636363636364,10.909090909090908,-5,0.17613636363636365,6.059659090909092,20,1
2018,140,3417,86,3166,64,3,11,0.7741935483870968,12.64516129032258,0.6,2.933333333333333,-8,0.17419354838709677,9.711827956989247,22,1
2018,144,3257,86,3390,59,1,4,0.9411764705882353,19.647058823529413,0.6875,6.4375,-3,0.2536764705882353,13.209558823529413,27,1
2018,144,3280,71,3301,57,1,4,0.9696969696969697,26.303030303030305,0.75,9.59375,-3,0.21969696969696972,16.709280303030305,14,1
2018,144,3333,72,3124,67,6,2,0.7666666666666667,15.5,0.96875,30.687500000000004,4,-0.20208333333333328,-15.187500000000004,5,1
2018,144,3417,84,3400,75,3,2,0.7741935483870968,12.64516129032258,0.8125,16.96875,1,-0.03830645161290325,-4.32358870967742,9,1
2018,145,3163,72,3181,59,1,5,1.0,36.90625,0.7333333333333333,12.833333333333334,-4,0.2666666666666667,24.072916666666664,13,1
2018,145,3323,90,3401,84,1,4,0.90625,18.5625,0.7272727272727273,9.757575757575758,-3,0.1789772727272727,8.804924242424242,6,1
2018,145,3332,83,3141,69,2,11,0.8823529411764706,18.823529411764707,0.8709677419354839,11.064516129032258,-9,0.011385199240986688,7.7590132827324485,14,1
2018,145,3376,79,3138,63,2,11,0.8125,15.53125,0.84375,13.3125,-9,-0.03125,2.21875,16,1
2018,146,3257,76,3333,43,1,6,0.9411764705882353,19.647058823529413,0.7666666666666667,15.5,-5,0.17450980392156856,4.147058823529413,33,1
2018,146,3280,89,3417,73,1,3,0.9696969696969697,26.303030303030305,0.7741935483870968,12.64516129032258,-2,0.19550342130987297,13.657869012707724,16,1
2018,147,3163,94,3376,65,1,2,1.0,36.90625,0.8125,15.53125,-1,0.1875,21.375,29,1
2018,147,3323,84,3332,74,1,2,0.90625,18.5625,0.8823529411764706,18.823529411764707,-1,0.023897058823529438,-0.2610294117647065,10,1
2018,151,3280,73,3257,63,1,1,0.9696969696969697,26.303030303030305,0.9411764705882353,19.647058823529413,0,0.028520499108734443,6.6559714795008915,10,1
2018,151,3323,91,3163,89,1,1,0.90625,18.5625,1.0,36.90625,0,-0.09375,-18.34375,2,1
2018,153,3323,61,3280,58,1,1,0.90625,18.5625,0.9696969696969697,26.303030303030305,0,-0.06344696969696972,-7.7405303030303045,3,1
2019,137,3113,60,3416,45,5,12,0.6666666666666666,8.1,0.8125,6.03125,-7,-0.14583333333333337,2.0687499999999996,15,1
2019,137,3138,82,3353,71,10,7,0.71875,9.500000000000002,0.7096774193548387,6.483870967741935,3,0.009072580645161255,3.0161290322580667,11,1
2019,137,3155,79,3377,66,9,8,0.6129032258064516,2.6129032258064515,0.8387096774193549,16.258064516129032,1,-0.22580645161290325,-13.64516129032258,13,1
2019,137,3163,110,3406,61,2,15,0.9393939393939394,28.03030303030303,0.625,1.5,-13,0.31439393939393945,26.53030303030303,49,1
2019,137,3199,70,3137,67,5,12,0.7419354838709677,7.935483870967742,0.8484848484848485,15.121212121212121,-7,-0.10654936461388076,-7.185728250244379,3,1
2019,137,3231,69,3400,65,10,7,0.625,4.375,0.71875,8.937499999999998,3,-0.09375,-4.562499999999998,4,1
2019,137,3234,66,3273,61,2,15,0.8125,12.25,0.78125,6.5,-13,0.03125,5.75,5,1
2019,137,3257,69,3352,34,1,16,0.90625,18.59375,0.6774193548387096,7.67741935483871,-15,0.22883064516129037,10.91633064516129,35,1
2019,137,3266,58,3349,54,5,12,0.7878787878787878,21.272727272727273,0.9032258064516129,13.548387096774194,-7,-0.11534701857282503,7.724340175953079,4,1
2019,137,3274,69,3195,62,4,13,0.75,10.5,0.8666666666666667,17.8,-9,-0.1166666666666667,-7.300000000000001,7,1
2019,137,3276,84,3243,54,8,9,0.65625,8.3125,0.65625,1.0,-1,0.0,7.3125,30,1
2019,137,3280,103,3380,46,1,16,0.9375,28.34375,0.6071428571428571,-2.857142857142857,-15,0.3303571428571429,31.200892857142858,57,1
2019,137,3281,77,3179,76,7,10,0.696969696969697,8.030303030303031,0.8125,13.28125,-3,-0.11553030303030298,-5.250946969696969,1,1
2019,137,3332,78,3340,40,2,15,0.875,21.40625,0.7741935483870968,10.612903225806452,-13,0.10080645161290325,10.793346774193548,38,1
2019,137,3376,74,3125,52,4,13,0.7,9.233333333333333,0.8125,16.09375,-9,-0.11250000000000004,-6.8604166666666675,22,1
2019,137,3401,84,3460,61,4,13,0.7741935483870968,9.741935483870968,0.8125,8.375,-9,-0.03830645161290325,1.366935483870968,23,1
2019,138,3124,95,3101,38,1,16,0.96875,25.9375,0.6785714285714286,6.392857142857143,-15,0.2901785714285714,19.544642857142858,57,1
2019,138,3140,73,3120,64,7,10,0.8064516129032258,6.451612903225806,0.7,8.233333333333333,-3,0.1064516129032258,-1.7817204301075265,9,1
2019,138,3143,92,3314,72,8,9,0.6129032258064516,3.4838709677419355,0.5625,4.28125,-1,0.050403225806451624,-0.7973790322580645,20,1
2019,138,3211,68,3114,51,5,12,0.875,15.03125,0.6774193548387096,5.225806451612903,-7,0.19758064516129037,9.805443548387096,17,1
2019,138,3235,97,3308,61,3,14,0.7575757575757576,14.969696969696969,0.8,7.333333333333333,-11,-0.042424242424242475,7.636363636363636,36,1
2019,138,3246,82,3343,77,6,11,0.7741935483870968,13.548387096774194,0.7096774193548387,7.645161290322581,-5,0.06451612903225801,5.903225806451613,5,1
2019,138,3268,73,3347,51,3,14,0.875,14.187500000000002,0.8064516129032258,9.193548387096774,-11,0.06854838709677424,4.993951612903228,22,1
2019,138,3277,88,3141,87,9,8,0.6451612903225806,7.774193548387097,0.78125,14.6875,1,-0.13608870967741937,-6.913306451612903,1,1
2019,138,3283,89,3177,78,11,6,0.71875,10.1875,0.7878787878787878,8.757575757575758,5,-0.06912878787878785,1.4299242424242422,11,1
2019,138,3301,63,3263,51,3,14,0.8387096774193549,10.870967741935484,0.78125,9.875,-11,0.05745967741935487,0.995967741935484,12,1
2019,138,3323,92,3126,50,1,16,0.9090909090909091,25.0,0.6551724137931034,1.4137931034482758,-15,0.25391849529780564,23.586206896551722,42,1
2019,138,3333,80,3129,75,4,13,0.7741935483870968,15.387096774193548,0.8666666666666667,8.766666666666667,-9,-0.09247311827956994,6.6204301075268805,5,1
2019,138,3355,76,3346,65,6,11,0.8125,17.53125,0.8125,14.71875,-5,0.0,2.8125,11,1
2019,138,3390,79,3413,54,2,15,0.875,13.999999999999998,0.8,14.333333333333334,-13,0.07499999999999996,-0.3333333333333357,25,1
2019,138,3393,70,3200,49,3,14,0.75,10.3125,0.7575757575757576,6.606060606060606,-11,-0.007575757575757569,3.7064393939393936,21,1
2019,138,3417,89,3397,77,6,11,0.625,5.15625,0.6129032258064516,6.096774193548387,-5,0.012096774193548376,-0.940524193548387,12,1
2019,139,3113,57,3274,55,5,4,0.6666666666666666,8.1,0.75,10.5,1,-0.08333333333333337,-2.4000000000000004,2,1
2019,139,3163,84,3138,72,2,10,0.9393939393939394,28.03030303030303,0.71875,9.500000000000002,-8,0.22064393939393945,18.53030303030303,12,1
2019,139,3234,68,3281,52,2,7,0.8125,12.25,0.696969696969697,8.030303030303031,-5,0.11553030303030298,4.219696969696969,16,1
2019,139,3257,71,3276,50,1,8,0.90625,18.59375,0.65625,8.3125,-7,0.25,10.28125,21,1
2019,139,3280,85,3155,61,1,9,0.9375,28.34375,0.6129032258064516,2.6129032258064515,-8,0.3245967741935484,25.730846774193548,24,1
2019,139,3332,91,3231,68,2,10,0.875,21.40625,0.625,4.375,-8,0.25,17.03125,23,1
2019,139,3376,72,3199,64,4,5,0.7,9.233333333333333,0.7419354838709677,7.935483870967742,-1,-0.041935483870967794,1.2978494623655905,8,1
2019,139,3401,78,3266,76,4,5,0.7741935483870968,9.741935483870968,0.7878787878787878,21.272727272727273,-1,-0.013685239491691092,-11.530791788856305,2,1
2019,140,3124,102,3143,63,1,8,0.96875,25.9375,0.6129032258064516,3.4838709677419355,-7,0.3558467741935484,22.453629032258064,39,1
2019,140,3283,69,3235,60,11,3,0.71875,10.1875,0.7575757575757576,14.969696969696969,8,-0.03882575757575757,-4.782196969696969,9,1
2019,140,3301,72,3246,57,3,6,0.8387096774193549,10.870967741935484,0.7741935483870968,13.548387096774194,-3,0.06451612903225812,-2.67741935483871,15,1
2019,140,3323,91,3277,63,1,9,0.9090909090909091,25.0,0.6451612903225806,7.774193548387097,-8,0.26392961876832843,17.225806451612904,28,1
2019,140,3333,76,3211,70,4,5,0.7741935483870968,15.387096774193548,0.875,15.03125,-1,-0.10080645161290325,0.35584677419354804,6,1
2019,140,3355,75,3393,64,6,3,0.8125,17.53125,0.75,10.3125,3,0.0625,7.21875,11,1
2019,140,3390,72,3140,63,2,7,0.875,13.999999999999998,0.8064516129032258,6.451612903225806,-5,0.06854838709677424,7.548387096774192,9,1
2019,140,3417,85,3268,80,6,3,0.625,5.15625,0.875,14.187500000000002,3,-0.25,-9.031250000000002,5,1
2019,144,3163,69,3417,61,2,6,0.9393939393939394,28.03030303030303,0.625,5.15625,-4,0.31439393939393945,22.87405303030303,8,1
2019,144,3257,61,3333,44,1,4,0.90625,18.59375,0.7741935483870968,15.387096774193548,-3,0.13205645161290325,3.206653225806452,17,1
2019,144,3280,76,3113,53,1,5,0.9375,28.34375,0.6666666666666666,8.1,-4,0.27083333333333337,20.24375,23,1
2019,144,3332,63,3355,53,2,6,0.875,21.40625,0.8125,17.53125,-4,0.0625,3.875,10,1
2019,145,3124,93,3376,68,1,4,0.96875,25.9375,0.7,9.233333333333333,-3,0.26875000000000004,16.704166666666666,25,1
2019,145,3234,79,3301,61,2,3,0.8125,12.25,0.8387096774193549,10.870967741935484,-1,-0.02620967741935487,1.379032258064516,18,1
2019,145,3323,87,3401,80,1,4,0.9090909090909091,25.0,0.7741935483870968,9.741935483870968,-3,0.1348973607038123,15.258064516129032,7,1
2019,145,3390,55,3283,46,2,11,0.875,13.999999999999998,0.71875,10.1875,-9,0.15625,3.8124999999999982,9,1
2019,146,3163,80,3257,73,2,1,0.9393939393939394,28.03030303030303,0.90625,18.59375,1,0.03314393939393945,9.436553030303031,7,1
2019,146,3332,88,3280,84,2,1,0.875,21.40625,0.9375,28.34375,1,-0.0625,-6.9375,4,1
2019,147,3124,85,3234,53,1,2,0.96875,25.9375,0.8125,12.25,-1,0.15625,13.6875,32,1
2019,147,3323,84,3390,68,1,2,0.9090909090909091,25.0,0.875,13.999999999999998,-1,0.03409090909090906,11.000000000000002,16,1
2019,151,3124,72,3332,67,1,2,0.96875,25.9375,0.875,21.40625,-1,0.09375,4.53125,5,1
2019,151,3323,81,3163,76,1,2,0.9090909090909091,25.0,0.9393939393939394,28.03030303030303,-1,-0.030303030303030387,-3.030303030303031,5,1
2019,153,3124,82,3323,81,1,1,0.96875,25.9375,0.9090909090909091,25.0,0,0.05965909090909094,0.9375,1,1
2021,139,3124,101,3238,52,2,15,0.9259259259259259,27.11111111111111,0.782608695652174,9.869565217391305,-13,0.14331723027375198,17.241545893719806,49,1
2021,139,3163,102,3219,59,1,16,0.96,31.52,0.7692307692307693,9.923076923076923,-15,0.1907692307692307,21.596923076923076,43,1
2021,139,3210,54,3372,52,5,12,0.6521739130434783,4.217391304347826,0.9166666666666666,28.708333333333332,-7,-0.26449275362318836,-24.490942028985508,2,1
2021,139,3234,87,3141,72,5,12,0.6666666666666666,6.111111111111111,0.6923076923076923,4.076923076923077,-7,-0.02564102564102566,2.034188034188034,15,1
2021,139,3246,71,3226,63,4,13,0.68,7.28,0.875,12.125,-9,-0.19499999999999995,-4.845,8,1
2021,139,3276,87,3195,66,6,11,0.7368421052631579,10.368421052631579,0.9230769230769231,22.23076923076923,-5,-0.18623481781376527,-11.862348178137651,21,1
2021,139,3301,79,3299,58,1,16,0.9090909090909091,15.772727272727273,0.8666666666666667,17.0,-15,0.042424242424242364,-1.2272727272727266,21,1
2021,139,3329,84,3448,61,8,9,0.6923076923076923,9.0,0.5,-1.2083333333333333,-1,0.1923076923076923,10.208333333333334,23,1
2021,139,3333,83,3199,59,8,9,0.5882352941176471,1.3529411764705883,0.5555555555555556,0.7777777777777778,-1,0.0326797385620915,0.5751633986928105,24,1
2021,139,3376,79,3273,53,1,16,0.8461538461538461,17.5,0.75,7.958333333333333,-15,0.09615384615384615,9.541666666666668,26,1
2021,139,3378,57,3450,53,8,9,0.8571428571428571,11.333333333333334,0.5217391304347826,-0.043478260869565216,-1,0.3354037267080745,11.376811594202898,4,1
2021,139,3390,87,3430,44,1,16,0.9259259259259259,25.703703703703702,0.6666666666666666,3.2777777777777777,-15,0.2592592592592593,22.425925925925924,43,1
2021,139,3393,72,3355,55,8,9,0.6190476190476191,2.857142857142857,0.875,10.166666666666666,-1,-0.25595238095238093,-7.309523809523808,17,1
2021,139,3397,87,3292,62,3,14,0.6956521739130435,9.73913043478261,0.7083333333333334,4.916666666666667,-11,-0.012681159420289911,4.822463768115942,25,1
2021,139,3439,70,3266,63,7,10,0.6086956521739131,8.08695652173913,0.76,9.4,-3,-0.15130434782608693,-1.3130434782608695,7,1
2021,139,3452,77,3250,53,4,13,0.7777777777777778,6.518518518518518,0.6428571428571429,5.214285714285714,-9,0.13492063492063489,1.3042328042328037,24,1
2021,140,3104,80,3314,71,7,10,0.64,4.76,0.5652173913043478,8.08695652173913,-3,0.07478260869565223,-3.326956521739131,9,1
2021,140,3112,79,3392,44,3,14,0.7619047619047619,10.523809523809524,0.75,9.6,-11,0.011904761904761862,0.9238095238095241,35,1
2021,140,3125,64,3211,59,12,5,0.8,12.32,0.8846153846153846,16.576923076923077,7,-0.08461538461538454,-4.256923076923076,5,1
2021,140,3140,69,3353,66,11,6,0.782608695652174,10.130434782608695,0.7777777777777778,18.5,5,0.004830917874396157,-8.369565217391305,3,1
2021,140,3208,67,3180,53,3,14,0.7692307692307693,11.384615384615385,0.6363636363636364,4.2272727272727275,-11,0.13286713286713292,7.1573426573426575,14,1
2021,140,3231,63,3433,32,4,13,0.782608695652174,15.173913043478262,0.6,2.4,-9,0.18260869565217397,12.773913043478261,31,1
2021,140,3235,79,3277,75,7,10,0.6153846153846154,5.923076923076923,0.6521739130434783,6.869565217391305,-3,-0.03678929765886285,-0.9464882943143813,4,1
2021,140,3257,74,3265,43,2,15,0.8846153846153846,16.884615384615383,0.8571428571428571,13.571428571428571,-13,0.027472527472527486,3.313186813186812,31,1
2021,140,3268,98,3291,45,2,15,0.9230769230769231,21.0,0.7272727272727273,11.863636363636363,-13,0.19580419580419584,9.136363636363637,53,1
2021,140,3283,70,3413,51,5,12,0.9090909090909091,11.818181818181818,0.8666666666666667,9.533333333333333,-7,0.042424242424242364,2.284848484848485,19,1
2021,140,3321,62,3416,51,7,10,0.6521739130434783,6.695652173913044,0.8,8.15,-3,-0.14782608695652177,-1.4543478260869565,11,1
2021,140,3332,67,3377,47,6,11,0.6190476190476191,12.476190476190476,0.782608695652174,14.869565217391305,-5,-0.16356107660455488,-2.3933747412008284,20,1
2021,140,3400,81,3133,62,6,11,0.6666666666666666,7.074074074074074,0.5925925925925926,4.592592592592593,-5,0.07407407407407407,2.481481481481482,19,1
2021,140,3401,84,3407,80,2,15,0.92,14.48,0.8,11.4,-13,0.12,3.08,4,1
2021,140,3417,69,3461,48,3,14,0.7619047619047619,13.80952380952381,0.6086956521739131,4.434782608695652,-11,0.15320910973084878,9.374741200828158,21,1
2021,140,3460,66,3116,62,13,4,0.72,8.2,0.7037037037037037,9.0,9,0.016296296296296253,-0.8000000000000007,4,1
2021,141,3124,90,3439,48,2,7,0.9259259259259259,27.11111111111111,0.6086956521739131,8.08695652173913,-5,0.31723027375201285,19.02415458937198,42,1
2021,141,3163,83,3393,47,1,8,0.96,31.52,0.6190476190476191,2.857142857142857,-7,0.3409523809523809,28.662857142857142,36,1
2021,141,3210,73,3452,56,5,4,0.6521739130434783,4.217391304347826,0.7777777777777778,6.518518518518518,1,-0.12560386473429952,-2.301127214170692,17,1
2021,141,3234,86,3246,72,5,4,0.6666666666666666,6.111111111111111,0.68,7.28,1,-0.01333333333333342,-1.1688888888888895,14,1
2021,141,3276,70,3397,55,6,3,0.7368421052631579,10.368421052631579,0.6956521739130435,9.73913043478261,3,0.041189931350114395,0.6292906178489694,15,1
2021,141,3301,79,3378,67,1,8,0.9090909090909091,15.772727272727273,0.8571428571428571,11.333333333333334,-7,0.051948051948051965,4.4393939393939394,12,1
2021,141,3376,59,3333,42,1,8,0.8461538461538461,17.5,0.5882352941176471,1.3529411764705883,-7,0.25791855203619907,16.147058823529413,17,1
2021,141,3390,73,3329,62,1,8,0.9259259259259259,25.703703703703702,0.6923076923076923,9.0,-7,0.23361823361823364,16.703703703703702,11,1
2021,142,3112,52,3140,46,3,11,0.7619047619047619,10.523809523809524,0.782608695652174,10.130434782608695,-8,-0.020703933747412084,0.3933747412008284,6,1
2021,142,3231,70,3125,48,4,12,0.782608695652174,15.173913043478262,0.8,12.32,-8,-0.017391304347826098,2.8539130434782614,22,1
2021,142,3257,62,3321,53,2,7,0.8846153846153846,16.884615384615383,0.6521739130434783,6.695652173913044,-5,0.2324414715719063,10.18896321070234,9,1
2021,142,3268,100,3104,64,2,7,0.9230769230769231,21.0,0.64,4.76,-5,0.2830769230769231,16.240000000000002,36,1
2021,142,3283,64,3460,39,5,13,0.9090909090909091,11.818181818181818,0.72,8.2,-8,0.1890909090909091,3.618181818181819,25,1
2021,142,3332,57,3208,50,6,3,0.6190476190476191,12.476190476190476,0.7692307692307693,11.384615384615385,3,-0.1501831501831502,1.0915750915750912,7,1
2021,142,3400,71,3417,62,6,3,0.6666666666666666,7.074074074074074,0.7619047619047619,13.80952380952381,3,-0.09523809523809523,-6.735449735449736,9,1
2021,142,3401,84,3235,82,2,7,0.92,14.48,0.6153846153846154,5.923076923076923,-5,0.3046153846153846,8.556923076923077,2,1
2021,145,3112,74,3401,59,3,2,0.7619047619047619,10.523809523809524,0.92,14.48,1,-0.15809523809523818,-3.9561904761904767,15,1
2021,145,3124,78,3276,75,2,6,0.9259259259259259,27.11111111111111,0.7368421052631579,10.368421052631579,-4,0.18908382066276808,16.742690058479532,3,1
2021,145,3163,92,3234,72,1,5,0.96,31.52,0.6666666666666666,6.111111111111111,-4,0.29333333333333333,25.40888888888889,20,1
2021,145,3231,73,3301,70,4,1,0.782608695652174,15.173913043478262,0.9090909090909091,15.772727272727273,3,-0.1264822134387351,-0.5988142292490117,3,1
2021,146,3257,60,3332,42,2,6,0.8846153846153846,16.884615384615383,0.6190476190476191,12.476190476190476,-4,0.2655677655677655,4.408424908424907,18,1
2021,146,3376,76,3210,65,1,5,0.8461538461538461,17.5,0.6521739130434783,4.217391304347826,-4,0.19397993311036787,13.282608695652174,11,1
2021,146,3390,89,3283,62,1,5,0.9259259259259259,25.703703703703702,0.9090909090909091,11.818181818181818,-4,0.01683501683501687,13.885521885521884,27,1
2021,146,3400,64,3268,61,6,2,0.6666666666666666,7.074074074074074,0.9230769230769231,21.0,4,-0.2564102564102565,-13.925925925925926,3,1
2021,147,3112,66,3231,53,3,4,0.7619047619047619,10.523809523809524,0.782608695652174,15.173913043478262,-1,-0.020703933747412084,-4.650103519668738,13,1
2021,147,3163,69,3124,67,1,2,0.96,31.52,0.9259259259259259,27.11111111111111,-1,0.034074074074074034,4.408888888888889,2,1
2021,148,3376,62,3400,34,1,6,0.8461538461538461,17.5,0.6666666666666666,7.074074074074074,-5,0.17948717948717952,10.425925925925926,28,1
2021,148,3390,78,3257,63,1,2,0.9259259259259259,25.703703703703702,0.8846153846153846,16.884615384615383,-1,0.04131054131054135,8.81908831908832,15,1
2021,151,3112,69,3163,59,3,1,0.7619047619047619,10.523809523809524,0.96,31.52,2,-0.1980952380952381,-20.996190476190478,10,1
2021,151,3390,66,3376,65,1,1,0.9259259259259259,25.703703703703702,0.8461538461538461,17.5,0,0.07977207977207978,8.203703703703702,1,1
2021,153,3390,54,3112,53,1,3,0.9259259259259259,25.703703703703702,0.7619047619047619,10.523809523809524,-2,0.16402116402116407,15.179894179894179,1,1
2022,135,3173,88,3177,57,11,11,0.8333333333333334,10.766666666666667,0.6875,10.0,0,0.14583333333333337,0.7666666666666675,31,1
2022,135,3224,55,3230,51,16,16,0.6785714285714286,3.392857142857143,0.4074074074074074,-3.5185185185185186,0,0.2711640211640212,6.911375661375661,4,1
2022,136,3255,74,3291,70,16,16,0.65625,4.3125,0.5384615384615384,0.4230769230769231,0,0.11778846153846156,3.889423076923077,4,1
2022,136,3283,61,3199,50,11,11,0.7666666666666667,10.033333333333333,0.5666666666666667,4.133333333333334,0,0.20000000000000007,5.8999999999999995,11,1
2022,137,3124,89,3218,49,2,15,0.8181818181818182,16.515151515151516,0.6896551724137931,1.4827586206896552,-13,0.12852664576802508,15.03239289446186,40,1
2022,137,3166,84,3160,74,10,7,0.6896551724137931,11.379310344827585,0.7333333333333333,8.533333333333333,3,-0.04367816091954013,2.845977011494252,10,1
2022,137,3195,84,3439,81,12,5,0.9285714285714286,17.53571428571429,0.71875,12.875,7,0.2098214285714286,4.660714285714288,3,1
2022,137,3208,70,3173,54,6,11,0.6896551724137931,10.137931034482758,0.8333333333333334,10.766666666666667,-5,-0.14367816091954022,-0.6287356321839095,16,1
2022,137,3211,68,3304,55,9,8,0.8125,13.562500000000002,0.75,14.34375,1,0.0625,-0.7812499999999982,13,1
2022,137,3234,98,3229,58,2,15,0.7666666666666667,13.666666666666664,0.5806451612903226,0.967741935483871,-13,0.1860215053763441,12.698924731182792,40,1
2022,137,3235,78,3426,71,3,14,0.8125,13.125,0.7407407407407407,3.925925925925926,-11,0.0717592592592593,9.199074074074074,7,1
2022,137,3242,77,3210,58,8,9,0.6896551724137931,7.275862068965517,0.6774193548387096,9.161290322580646,-1,0.012235817575083519,-1.885428253615129,19,1
2022,137,3257,83,3107,51,1,16,0.8620689655172413,17.13793103448276,0.7096774193548387,7.354838709677419,-15,0.15239154616240258,9.783092324805342,32,1
2022,137,3268,102,3174,71,4,13,0.7241379310344828,11.10344827586207,0.7666666666666667,8.366666666666667,-9,-0.042528735632183956,2.7367816091954023,31,1
2022,137,3274,78,3378,66,8,9,0.625,2.78125,0.75,6.9375,-1,-0.125,-4.15625,12,1
2022,137,3376,79,3224,21,1,16,0.9354838709677419,19.612903225806452,0.6785714285714286,3.392857142857143,-15,0.2569124423963133,16.22004608294931,58,1
2022,137,3377,75,3279,61,10,7,0.8387096774193549,15.483870967741936,0.7419354838709677,11.161290322580646,3,0.09677419354838712,4.32258064516129,14,1
2022,137,3390,78,3286,37,1,16,0.9032258064516129,16.903225806451612,0.625,2.0,-15,0.2782258064516129,14.903225806451612,41,1
2022,137,3400,70,3193,52,2,15,0.8125,15.96875,0.8064516129032258,8.516129032258064,-13,0.006048387096774244,7.452620967741936,18,1
2022,137,3428,92,3116,69,7,10,0.6451612903225806,8.161290322580646,0.5806451612903226,8.03225806451613,-3,0.06451612903225801,0.12903225806451601,23,1
2022,138,3112,72,3424,67,4,13,0.7407407407407407,11.037037037037036,0.8125,11.09375,-9,-0.0717592592592593,-0.05671296296296369,5,1
2022,138,3125,73,3332,70,12,5,0.7586206896551724,13.965517241379313,0.6333333333333333,9.8,7,0.12528735632183907,4.1655172413793125,3,1
2022,138,3163,83,3273,38,2,15,0.8333333333333334,20.6,0.7931034482758621,9.344827586206897,-13,0.04022988505747127,11.255172413793105,45,1
2022,138,3231,85,3150,51,3,14,0.7333333333333333,9.9,0.7096774193548387,5.483870967741935,-11,0.023655913978494536,4.416129032258065,34,1
2022,138,3243,50,3450,40,9,8,0.6129032258064516,6.516129032258065,0.6551724137931034,0.41379310344827586,1,-0.0422691879866518,6.102335928809789,10,1
2022,138,3261,83,3238,77,3,14,0.8333333333333334,13.2,0.7931034482758621,17.724137931034484,-11,0.04022988505747127,-4.524137931034485,6,1
2022,138,3276,74,3110,39,3,14,0.7857142857142857,11.178571428571429,0.7419354838709677,4.0,-11,0.04377880184331795,7.178571428571429,35,1
2022,138,3301,96,3255,68,1,16,0.90625,19.34375,0.65625,4.3125,-15,0.25,15.03125,28,1
2022,138,3314,79,3372,66,5,12,0.7931034482758621,18.344827586206897,0.8666666666666667,16.533333333333335,-7,-0.0735632183908046,1.8114942528735618,13,1
2022,138,3323,89,3269,78,5,12,0.7333333333333333,10.366666666666667,0.8125,10.75,-7,-0.07916666666666672,-0.38333333333333286,11,1
2022,138,3326,63,3283,56,6,11,0.7931034482758621,13.241379310344827,0.7666666666666667,10.033333333333333,-5,0.02643678160919538,3.208045977011494,7,1
2022,138,3328,78,3237,72,4,13,0.75,7.28125,0.8571428571428571,14.75,-9,-0.1071428571428571,-7.46875,6,1
2022,138,3343,69,3246,62,11,6,0.8518518518518519,17.814814814814813,0.6333333333333333,6.966666666666667,5,0.21851851851851856,10.848148148148146,7,1
2022,138,3397,80,3138,67,4,13,0.7419354838709677,9.741935483870968,0.7575757575757576,9.848484848484848,-9,-0.01564027370478982,-0.10654936461387976,13,1
2022,138,3416,69,3196,52,7,10,0.8928571428571429,13.214285714285714,0.6774193548387096,3.903225806451613,-3,0.21543778801843327,9.3110599078341,17,1
2022,138,3437,61,3140,57,11,6,0.7419354838709677,4.67741935483871,0.896551724137931,19.586206896551722,5,-0.1546162402669633,-14.908787541713012,4,1
2022,139,3166,64,3234,62,10,2,0.6896551724137931,11.379310344827585,0.7666666666666667,13.666666666666664,8,-0.07701149425287357,-2.287356321839079,2,1
2022,139,3235,67,3208,44,3,6,0.8125,13.125,0.6896551724137931,10.137931034482758,-3,0.12284482758620685,2.987068965517242,23,1
2022,139,3257,68,3211,59,1,9,0.8620689655172413,17.13793103448276,0.8125,13.562500000000002,-8,0.049568965517241326,3.57543103448276,9,1
2022,139,3268,89,3195,65,4,12,0.7241379310344828,11.10344827586207,0.9285714285714286,17.53571428571429,-8,-0.20443349753694584,-6.432266009852219,24,1
2022,139,3376,49,3274,33,1,8,0.9354838709677419,19.612903225806452,0.625,2.78125,-7,0.3104838709677419,16.831653225806452,16,1
2022,139,3377,61,3124,47,10,2,0.8387096774193549,15.483870967741936,0.8181818181818182,16.515151515151516,8,0.02052785923753664,-1.0312805474095796,14,1
2022,139,3390,91,3242,65,1,8,0.9032258064516129,16.903225806451612,0.6896551724137931,7.275862068965517,-7,0.21357063403781973,9.627363737486096,26,1
2022,139,3400,78,3428,56,2,7,0.8125,15.96875,0.6451612903225806,8.161290322580646,-5,0.16733870967741937,7.807459677419354,22,1
2022,140,3163,52,3416,47,2,7,0.8333333333333334,20.6,0.8928571428571429,13.214285714285714,-5,-0.059523809523809534,7.385714285714288,5,1
2022,140,3231,56,3343,55,3,11,0.7333333333333333,9.9,0.8518518518518519,17.814814814814813,-8,-0.11851851851851858,-7.914814814814813,1,1
2022,140,3276,64,3437,49,3,11,0.7857142857142857,11.178571428571429,0.7419354838709677,4.67741935483871,-8,0.04377880184331795,6.501152073732719,15,1
2022,140,3301,89,3243,57,1,9,0.90625,19.34375,0.6129032258064516,6.516129032258065,-8,0.2933467741935484,12.827620967741936,32,1
2022,140,3314,63,3112,45,5,4,0.7931034482758621,18.344827586206897,0.7407407407407407,11.037037037037036,1,0.0523627075351214,7.3077905491698605,18,1
2022,140,3323,108,3328,64,5,4,0.7333333333333333,10.366666666666667,0.75,7.28125,1,-0.01666666666666672,3.085416666666667,44,1
2022,140,3326,79,3261,64,6,3,0.7931034482758621,13.241379310344827,0.8333333333333334,13.2,3,-0.04022988505747127,0.04137931034482811,15,1
2022,140,3397,70,3125,67,4,12,0.7419354838709677,9.741935483870968,0.7586206896551724,13.965517241379313,-8,-0.016685205784204626,-4.223581757508345,3,1
2022,144,3166,76,3235,68,10,3,0.6896551724137931,11.379310344827585,0.8125,13.125,7,-0.12284482758620685,-1.7456896551724146,8,1
2022,144,3376,69,3314,61,1,5,0.9354838709677419,19.612903225806452,0.7931034482758621,18.344827586206897,-4,0.14238042269187978,1.2680756395995552,8,1
2022,144,3390,72,3268,66,1,4,0.9032258064516129,16.903225806451612,0.7241379310344828,11.10344827586207,-3,0.17908787541713012,5.799777530589543,6,1
2022,144,3400,66,3326,63,2,6,0.8125,15.96875,0.7931034482758621,13.241379310344827,-4,0.0193965517241379,2.7273706896551726,3,1
2022,145,3163,75,3231,58,2,3,0.8333333333333334,20.6,0.7333333333333333,9.9,-1,0.10000000000000009,10.700000000000001,17,1
2022,145,3257,76,3397,64,1,4,0.8620689655172413,17.13793103448276,0.7419354838709677,9.741935483870968,-3,0.12013348164627358,7.395995550611794,12,1
2022,145,3276,52,3377,49,3,10,0.7857142857142857,11.178571428571429,0.8387096774193549,15.483870967741936,-7,-0.05299539170506917,-4.305299539170507,3,1
2022,145,3301,66,3323,63,1,5,0.90625,19.34375,0.7333333333333333,10.366666666666667,-4,0.17291666666666672,8.977083333333333,3,1
2022,146,3376,80,3166,50,1,10,0.9354838709677419,19.612903225806452,0.6896551724137931,11.379310344827585,-9,0.24582869855394873,8.233592880978867,30,1
2022,146,3390,59,3400,50,1,2,0.9032258064516129,16.903225806451612,0.8125,15.96875,-1,0.09072580645161288,0.9344758064516121,9,1
2022,147,3163,91,3301,87,2,1,0.8333333333333334,20.6,0.90625,19.34375,1,-0.07291666666666663,1.2562500000000014,4,1
2022,147,3257,62,3276,50,1,3,0.8620689655172413,17.13793103448276,0.7857142857142857,11.178571428571429,-2,0.07635467980295563,5.959359605911333,12,1
2022,151,3163,63,3390,58,2,1,0.8333333333333334,20.6,0.9032258064516129,16.903225806451612,1,-0.06989247311827951,3.6967741935483893,5,1
2022,151,3376,72,3257,59,1,1,0.9354838709677419,19.612903225806452,0.8620689655172413,17.13793103448276,0,0.07341490545050056,2.4749721913236904,13,1
2022,153,3376,64,3163,49,1,2,0.9354838709677419,19.612903225806452,0.8333333333333334,20.6,-1,0.10215053763440851,-0.9870967741935495,15,1
2016,134,1195,96,1192,65,16,16,0.5517241379310345,2.7241379310344827,0.5483870967741935,-1.6774193548387097,0,0.0033370411568409697,4.401557285873192,31,1
2016,134,1455,70,1435,50,11,11,0.7419354838709677,13.709677419354838,0.59375,9.40625,0,0.14818548387096775,4.303427419354838,20,1
2016,135,1221,59,1380,55,16,16,0.42424242424242425,-4.333333333333333,0.6129032258064516,1.8709677419354838,0,-0.18866080156402737,-6.204301075268817,4,1
2016,135,1276,67,1409,62,11,11,0.6363636363636364,6.242424242424244,0.6451612903225806,4.32258064516129,0,-0.008797653958944274,1.919843597262954,5,1
2016,136,1114,85,1345,83,12,5,0.8709677419354839,9.935483870967742,0.7647058823529411,13.147058823529413,7,0.10626185958254275,-3.211574952561671,2,1
2016,136,1139,71,1403,61,9,8,0.6774193548387096,9.419354838709678,0.6129032258064516,2.5483870967741935,1,0.06451612903225801,6.870967741935484,10,1
2016,136,1163,74,1160,67,9,8,0.7058823529411765,10.323529411764707,0.65625,4.75,1,0.049632352941176516,5.5735294117647065,7,1
2016,136,1181,93,1423,85,4,13,0.696969696969697,9.393939393939394,0.7666666666666667,6.366666666666666,-9,-0.0696969696969697,3.0272727272727282,8,1
2016,136,1211,68,1371,52,11,6,0.78125,12.75,0.7575757575757576,7.0606060606060606,5,0.02367424242424243,5.6893939393939394,16,1
2016,136,1231,99,1151,74,5,12,0.78125,13.374999999999998,0.84375,7.6875,-7,-0.0625,5.687499999999998,25,1
2016,136,1235,94,1233,81,4,13,0.65625,6.875,0.6875,5.9375,-9,-0.03125,0.9375,13,1
2016,136,1242,105,1122,79,1,16,0.8787878787878788,12.696969696969697,0.48484848484848486,-2.3636363636363638,-15,0.3939393939393939,15.06060606060606,26,1
2016,136,1246,85,1392,57,4,13,0.7647058823529411,11.411764705882353,0.8,10.266666666666667,-9,-0.03529411764705892,1.1450980392156858,28,1
2016,136,1274,79,1138,72,3,14,0.78125,8.8125,0.5757575757575758,0.6666666666666659,-11,0.2054924242424242,8.145833333333334,7,1
2016,136,1314,83,1195,67,1,16,0.8235294117647058,12.705882352941176,0.5517241379310345,2.7241379310344827,-15,0.27180527383367137,9.981744421906694,16,1
2016,136,1344,70,1425,69,9,8,0.696969696969697,4.242424242424241,0.6363636363636364,6.090909090909091,1,0.06060606060606066,-1.8484848484848495,1,1
2016,136,1428,80,1201,69,3,14,0.7575757575757576,7.484848484848484,0.71875,3.468749999999999,-11,0.03882575757575757,4.016098484848485,11,1
2016,136,1438,81,1214,45,1,16,0.7878787878787878,10.696969696969697,0.6666666666666666,0.9,-15,0.12121212121212122,9.796969696969697,36,1
2016,136,1455,65,1112,55,11,6,0.7419354838709677,13.709677419354838,0.7575757575757576,12.212121212121215,5,-0.01564027370478982,1.4975562072336235,10,1
2016,136,1463,79,1124,75,12,5,0.7777777777777778,10.962962962962964,0.65625,6.6875,7,0.12152777777777779,4.275462962962964,4,1
2016,137,1218,77,1143,66,13,4,0.8333333333333334,10.8,0.696969696969697,8.090909090909092,9,0.13636363636363635,2.709090909090909,11,1
2016,137,1234,72,1396,70,7,10,0.6774193548387096,9.387096774193548,0.65625,1.2187499999999991,-3,0.02116935483870963,8.168346774193548,2,1
2016,137,1268,79,1355,74,5,12,0.75,9.125,0.7741935483870968,7.032258064516129,-7,-0.024193548387096753,2.092741935483871,5,1
2016,137,1292,90,1277,81,15,2,0.7096774193548387,4.096774193548387,0.8529411764705882,16.38235294117647,13,-0.14326375711574946,-12.285578747628083,9,1
2016,137,1320,75,1400,72,11,6,0.6363636363636364,4.636363636363637,0.625,3.28125,5,0.011363636363636354,1.3551136363636367,3,1
2016,137,1323,70,1276,63,6,11,0.65625,5.125,0.6363636363636364,6.242424242424244,-5,0.019886363636363646,-1.117424242424244,7,1
2016,137,1328,82,1167,68,2,15,0.78125,9.96875,0.7241379310344828,8.482758620689655,-13,0.05711206896551724,1.4859913793103452,14,1
2016,137,1332,91,1221,52,1,16,0.8181818181818182,9.151515151515152,0.42424242424242425,-4.333333333333333,-15,0.393939393939394,13.484848484848484,39,1
2016,137,1372,70,1452,56,14,3,0.8214285714285714,15.285714285714283,0.7647058823529411,12.588235294117647,11,0.05672268907563027,2.697478991596636,14,1
2016,137,1386,78,1153,76,8,9,0.7941176470588235,7.676470588235294,0.6875,10.312499999999998,-1,0.10661764705882348,-2.636029411764704,2,1
2016,137,1393,70,1173,51,10,7,0.59375,4.5,0.78125,7.375,3,-0.1875,-2.875,19,1
2016,137,1401,92,1453,65,3,14,0.7647058823529411,10.382352941176471,0.6363636363636364,2.696969696969697,-11,0.12834224598930477,7.685383244206774,27,1
2016,137,1433,75,1333,67,10,7,0.7058823529411765,9.911764705882353,0.6,1.4333333333333333,3,0.10588235294117654,8.47843137254902,8,1
2016,137,1437,86,1421,56,2,15,0.8529411764705882,13.264705882352942,0.6451612903225806,5.451612903225806,-13,0.20777988614800758,7.813092979127136,30,1
2016,137,1458,47,1338,43,7,10,0.625,4.3125,0.6451612903225806,7.064516129032258,-3,-0.020161290322580627,-2.752016129032258,4,1
2016,137,1462,71,1451,53,2,15,0.84375,10.3125,0.7419354838709677,6.064516129032259,-13,0.10181451612903225,4.247983870967741,18,1
2016,138,1181,71,1463,64,4,12,0.696969696969697,9.393939393939394,0.7777777777777778,10.962962962962964,-8,-0.08080808080808077,-1.5690235690235692,7,1
2016,138,1211,82,1428,59,11,3,0.78125,12.75,0.7575757575757576,7.484848484848484,8,0.02367424242424243,5.265151515151516,23,1
2016,138,1231,73,1246,67,5,4,0.78125,13.374999999999998,0.7647058823529411,11.411764705882353,1,0.016544117647058876,1.963235294117645,6,1
2016,138,1235,78,1114,61,4,12,0.65625,6.875,0.8709677419354839,9.935483870967742,-8,-0.21471774193548387,-3.060483870967742,17,1
2016,138,1242,73,1163,61,1,9,0.8787878787878788,12.696969696969697,0.7058823529411765,10.323529411764707,-8,0.17290552584670227,2.3734402852049907,12,1
2016,138,1274,65,1455,57,3,11,0.78125,8.8125,0.7419354838709677,13.709677419354838,-8,0.03931451612903225,-4.897177419354838,8,1
2016,138,1314,85,1344,66,1,9,0.8235294117647058,12.705882352941176,0.696969696969697,4.242424242424241,-8,0.12655971479500883,8.463458110516935,19,1
2016,138,1438,77,1139,69,1,9,0.7878787878787878,10.696969696969697,0.6774193548387096,9.419354838709678,-8,0.11045943304007821,1.2776148582600193,8,1
2016,139,1268,73,1218,60,5,13,0.75,9.125,0.8333333333333334,10.8,-8,-0.08333333333333337,-1.6750000000000007,13,1
2016,139,1323,76,1372,75,6,14,0.65625,5.125,0.8214285714285714,15.285714285714283,-8,-0.1651785714285714,-10.160714285714283,1,1
2016,139,1328,85,1433,81,2,10,0.78125,9.96875,0.7058823529411765,9.911764705882353,-8,0.07536764705882348,0.056985294117646745,4,1
2016,139,1332,69,1386,64,1,8,0.8181818181818182,9.151515151515152,0.7941176470588235,7.676470588235294,-7,0.02406417112299475,1.475044563279858,5,1
2016,139,1393,75,1292,50,10,15,0.59375,4.5,0.7096774193548387,4.096774193548387,-5,-0.11592741935483875,0.403225806451613,25,1
2016,139,1401,92,1320,88,3,11,0.7647058823529411,10.382352941176471,0.6363636363636364,4.636363636363637,-8,0.12834224598930477,5.745989304812834,4,1
2016,139,1437,87,1234,68,2,7,0.8529411764705882,13.264705882352942,0.6774193548387096,9.387096774193548,-5,0.17552182163187857,3.877609108159394,19,1
2016,139,1458,66,1462,63,7,2,0.625,4.3125,0.84375,10.3125,5,-0.21875,-6.0,3,1
2016,143,1242,79,1268,63,1,5,0.8787878787878788,12.696969696969697,0.75,9.125,-4,0.12878787878787878,3.5719696969696972,16,1
2016,143,1328,77,1401,63,2,3,0.78125,9.96875,0.7647058823529411,10.382352941176471,-1,0.016544117647058876,-0.413602941176471,14,1
2016,143,1332,82,1181,68,1,4,0.8181818181818182,9.151515151515152,0.696969696969697,9.393939393939394,-3,0.12121212121212122,-0.2424242424242422,14,1
2016,143,1437,92,1274,69,2,3,0.8529411764705882,13.264705882352942,0.78125,8.8125,-1,0.0716911764705882,4.452205882352942,23,1
2016,144,1314,101,1231,86,1,5,0.8235294117647058,12.705882352941176,0.78125,13.374999999999998,-4,0.04227941176470584,-0.6691176470588225,15,1
2016,144,1323,61,1458,56,6,7,0.65625,5.125,0.625,4.3125,-1,0.03125,0.8125,5,1
2016,144,1393,63,1211,60,10,11,0.59375,4.5,0.78125,12.75,-1,-0.1875,-8.25,3,1
2016,144,1438,84,1235,71,1,4,0.7878787878787878,10.696969696969697,0.65625,6.875,-3,0.13162878787878785,3.8219696969696972,13,1
2016,145,1328,80,1332,68,2,1,0.78125,9.96875,0.8181818181818182,9.151515151515152,1,-0.03693181818181823,0.8172348484848477,12,1
2016,145,1437,64,1242,59,2,1,0.8529411764705882,13.264705882352942,0.8787878787878788,12.696969696969697,1,-0.025846702317290582,0.5677361853832448,5,1
2016,146,1314,88,1323,74,1,6,0.8235294117647058,12.705882352941176,0.65625,5.125,-5,0.16727941176470584,7.580882352941176,14,1
2016,146,1393,68,1438,62,10,1,0.59375,4.5,0.7878787878787878,10.696969696969697,9,-0.19412878787878785,-6.196969696969697,6,1
2016,152,1314,83,1393,66,1,10,0.8235294117647058,12.705882352941176,0.59375,4.5,-9,0.22977941176470584,8.205882352941176,17,1
2016,152,1437,95,1328,51,2,2,0.8529411764705882,13.264705882352942,0.78125,9.96875,0,0.0716911764705882,3.295955882352942,44,1
2016,154,1437,77,1314,74,2,1,0.8529411764705882,13.264705882352942,0.8235294117647058,12.705882352941176,1,0.02941176470588236,0.5588235294117663,3,1
2017,134,1243,95,1448,88,11,11,0.6060606060606061,4.787878787878788,0.59375,4.75,0,0.012310606060606077,0.03787878787878807,7,1
2017,134,1291,67,1309,66,16,16,0.5588235294117647,-0.2647058823529412,0.6071428571428571,1.3214285714285714,0,-0.048319327731092376,-1.5861344537815125,1,1
2017,135,1413,67,1300,63,16,16,0.625,0.5,0.7333333333333333,9.433333333333334,0,-0.10833333333333328,-8.933333333333334,4,1
2017,135,1425,75,1344,71,11,11,0.7272727272727273,5.515151515151516,0.625,3.625,0,0.10227272727272729,1.8901515151515156,4,1
2017,136,1112,100,1315,82,2,15,0.8823529411764706,10.823529411764707,0.6785714285714286,4.3928571428571415,-13,0.20378151260504196,6.430672268907565,18,1
2017,136,1139,76,1457,64,4,13,0.7419354838709677,7.903225806451613,0.8,8.1,-9,-0.058064516129032295,-0.19677419354838666,12,1
2017,136,1196,80,1190,65,4,13,0.75,11.71875,0.78125,10.1875,-9,-0.03125,1.53125,15,1
2017,136,1199,86,1195,80,3,14,0.7575757575757576,11.18181818181818,0.7666666666666667,6.066666666666666,-11,-0.00909090909090915,5.1151515151515135,6,1
2017,136,1211,66,1355,46,1,16,0.9696969696969697,23.424242424242426,0.5,-1.0625,-15,0.4696969696969697,24.486742424242426,20,1
2017,136,1235,84,1305,73,5,12,0.696969696969697,8.878787878787879,0.8235294117647058,9.029411764705882,-7,-0.12655971479500883,-0.15062388591800335,11,1
2017,136,1292,81,1278,72,12,5,0.8787878787878788,10.909090909090908,0.7272727272727273,6.181818181818182,7,0.1515151515151515,4.727272727272727,9,1
2017,136,1321,68,1435,66,8,9,0.6764705882352942,6.029411764705882,0.5588235294117647,3.1176470588235294,-1,0.11764705882352944,2.911764705882353,2,1
2017,136,1323,60,1343,58,5,12,0.7352941176470589,8.794117647058824,0.7857142857142857,8.785714285714286,-7,-0.05042016806722682,0.008403361344537785,2,1
2017,136,1345,80,1436,70,4,13,0.78125,12.96875,0.8484848484848485,10.545454545454545,-9,-0.06723484848484851,2.423295454545455,10,1
2017,136,1388,85,1433,77,7,10,0.875,15.5,0.7647058823529411,8.264705882352942,-3,0.11029411764705888,7.235294117647058,8,1
2017,136,1437,76,1291,56,1,16,0.9117647058823529,14.882352941176471,0.5588235294117647,-0.2647058823529412,-15,0.3529411764705882,15.147058823529413,20,1
2017,136,1438,76,1423,71,5,12,0.6875,10.96875,0.84375,9.03125,-7,-0.15625,1.9375,5,1
2017,136,1452,86,1137,80,4,13,0.7647058823529411,15.647058823529411,0.7647058823529411,8.794117647058824,-9,0.0,6.852941176470587,6,1
2017,136,1458,84,1439,74,8,9,0.7352941176470589,10.529411764705882,0.6875,4.84375,-1,0.047794117647058876,5.685661764705882,10,1
2017,136,1462,76,1268,65,11,6,0.6176470588235294,3.264705882352941,0.7419354838709677,5.0,5,-0.12428842504743831,-1.7352941176470589,11,1
2017,137,1116,77,1371,71,8,9,0.7352941176470589,5.794117647058823,0.65625,3.1249999999999996,-1,0.07904411764705888,2.669117647058824,6,1
2017,137,1124,91,1308,73,3,14,0.7741935483870968,8.580645161290322,0.8333333333333334,9.366666666666667,-11,-0.05913978494623662,-0.7860215053763451,18,1
2017,137,1153,75,1243,61,6,11,0.8529411764705882,13.647058823529411,0.6060606060606061,4.787878787878788,-5,0.24688057040998213,8.859180035650624,14,1
2017,137,1181,87,1407,65,2,15,0.7714285714285715,10.828571428571431,0.5882352941176471,3.6176470588235294,-13,0.18319327731092439,7.210924369747902,22,1
2017,137,1242,100,1413,62,1,16,0.875,10.34375,0.625,0.5,-15,0.25,9.84375,38,1
2017,137,1246,79,1297,70,2,15,0.8529411764705882,14.352941176470589,0.6875,3.03125,-13,0.1654411764705882,11.321691176470589,9,1
2017,137,1257,78,1240,63,2,15,0.75,11.6875,0.5625,0.875,-13,0.1875,10.8125,15,1
2017,137,1276,92,1329,91,7,10,0.6857142857142857,9.257142857142858,0.6129032258064516,7.225806451612903,-3,0.0728110599078341,2.031336405529955,1,1
2017,137,1277,78,1274,58,9,8,0.5757575757575758,3.3636363636363638,0.65625,5.6875,1,-0.0804924242424242,-2.3238636363636362,20,1
2017,137,1314,103,1411,64,1,16,0.7878787878787878,13.424242424242426,0.6764705882352942,2.588235294117648,-15,0.11140819964349369,10.836007130124777,39,1
2017,137,1332,93,1233,77,3,14,0.8484848484848485,13.303030303030303,0.6470588235294118,4.117647058823529,-11,0.2014260249554367,9.185383244206774,16,1
2017,137,1348,84,1166,72,11,6,0.7272727272727273,8.484848484848484,0.7272727272727273,8.93939393939394,5,0.0,-0.45454545454545503,12,1
2017,137,1376,93,1266,73,7,10,0.6774193548387096,6.935483870967742,0.6129032258064516,7.516129032258065,-3,0.06451612903225801,-0.580645161290323,20,1
2017,137,1417,97,1245,80,3,14,0.8787878787878788,15.030303030303031,0.6176470588235294,3.088235294117648,-11,0.26114081996434935,11.942067736185383,17,1
2017,137,1425,66,1374,65,11,6,0.7272727272727273,5.515151515151516,0.8823529411764706,14.705882352941176,5,-0.15508021390374327,-9.19073083778966,1,1
2017,137,1455,64,1173,58,10,7,0.8787878787878788,19.303030303030305,0.7666666666666667,9.2,3,0.11212121212121207,10.103030303030305,6,1
2017,138,1112,69,1388,60,2,7,0.8823529411764706,10.823529411764707,0.875,15.5,-5,0.007352941176470562,-4.6764705882352935,9,1
2017,138,1139,74,1292,65,4,12,0.7419354838709677,7.903225806451613,0.8787878787878788,10.909090909090908,-8,-0.13685239491691104,-3.0058651026392953,9,1
2017,138,1196,65,1438,39,4,5,0.75,11.71875,0.6875,10.96875,-1,0.0625,0.75,26,1
2017,138,1211,79,1321,73,1,8,0.9696969696969697,23.424242424242426,0.6764705882352942,6.029411764705882,-7,0.29322638146167557,17.394830659536545,6,1
2017,138,1345,80,1235,76,4,5,0.78125,12.96875,0.696969696969697,8.878787878787879,-1,0.08428030303030298,4.089962121212121,4,1
2017,138,1452,83,1323,71,4,5,0.7647058823529411,15.647058823529411,0.7352941176470589,8.794117647058824,-1,0.02941176470588225,6.852941176470587,12,1
2017,138,1458,65,1437,62,8,1,0.7352941176470589,10.529411764705882,0.9117647058823529,14.882352941176471,7,-0.17647058823529405,-4.352941176470589,3,1
2017,138,1462,91,1199,66,11,3,0.6176470588235294,3.264705882352941,0.7575757575757576,11.18181818181818,8,-0.13992869875222813,-7.917112299465239,25,1
2017,139,1124,82,1425,78,3,11,0.7741935483870968,8.580645161290322,0.7272727272727273,5.515151515151516,-8,0.04692082111436946,3.0654936461388065,4,1
2017,139,1242,90,1277,70,1,9,0.875,10.34375,0.5757575757575758,3.3636363636363638,-8,0.2992424242424242,6.980113636363637,20,1
2017,139,1246,65,1455,62,2,10,0.8529411764705882,14.352941176470589,0.8787878787878788,19.303030303030305,-8,-0.025846702317290582,-4.950089126559716,3,1
2017,139,1276,73,1257,69,7,2,0.6857142857142857,9.257142857142858,0.75,11.6875,5,-0.06428571428571428,-2.430357142857142,4,1
2017,139,1314,72,1116,65,1,8,0.7878787878787878,13.424242424242426,0.7352941176470589,5.794117647058823,-7,0.05258467023172897,7.630124777183602,7,1
2017,139,1332,75,1348,72,3,11,0.8484848484848485,13.303030303030303,0.7272727272727273,8.484848484848484,-8,0.12121212121212122,4.818181818181818,3,1
2017,139,1376,88,1181,81,7,2,0.6774193548387096,6.935483870967742,0.7714285714285715,10.828571428571431,5,-0.09400921658986183,-3.893087557603689,7,1
2017,139,1417,79,1153,67,3,6,0.8787878787878788,15.030303030303031,0.8529411764705882,13.647058823529411,-3,0.025846702317290582,1.38324420677362,12,1
2017,143,1211,61,1452,58,1,4,0.9696969696969697,23.424242424242426,0.7647058823529411,15.647058823529411,-3,0.2049910873440286,7.777183600713014,3,1
2017,143,1242,98,1345,66,1,4,0.875,10.34375,0.78125,12.96875,-3,0.09375,-2.625,32,1
2017,143,1332,69,1276,68,3,7,0.8484848484848485,13.303030303030303,0.6857142857142857,9.257142857142858,-4,0.1627705627705628,4.045887445887445,1,1
2017,143,1462,73,1112,71,11,2,0.6176470588235294,3.264705882352941,0.8823529411764706,10.823529411764707,9,-0.2647058823529411,-7.558823529411765,2,1
2017,144,1196,84,1458,83,4,8,0.75,11.71875,0.7352941176470589,10.529411764705882,-4,0.014705882352941124,1.1893382352941178,1,1
2017,144,1246,86,1417,75,2,3,0.8529411764705882,14.352941176470589,0.8787878787878788,15.030303030303031,-1,-0.025846702317290582,-0.6773618538324424,11,1
2017,144,1314,92,1139,80,1,4,0.7878787878787878,13.424242424242426,0.7419354838709677,7.903225806451613,-3,0.045943304007820096,5.521016617790813,12,1
2017,144,1376,70,1124,50,7,3,0.6774193548387096,6.935483870967742,0.7741935483870968,8.580645161290322,4,-0.09677419354838712,-1.64516129032258,20,1
2017,145,1211,83,1462,59,1,11,0.9696969696969697,23.424242424242426,0.6176470588235294,3.264705882352941,-10,0.3520499108734403,20.159536541889484,24,1
2017,145,1332,74,1242,60,3,1,0.8484848484848485,13.303030303030303,0.875,10.34375,2,-0.02651515151515149,2.9592803030303028,14,1
2017,146,1314,75,1246,73,1,2,0.7878787878787878,13.424242424242426,0.8529411764705882,14.352941176470589,-1,-0.06506238859180036,-0.9286987522281631,2,1
2017,146,1376,77,1196,70,7,4,0.6774193548387096,6.935483870967742,0.75,11.71875,3,-0.07258064516129037,-4.783266129032258,7,1
2017,152,1211,77,1376,73,1,7,0.9696969696969697,23.424242424242426,0.6774193548387096,6.935483870967742,-6,0.2922776148582601,16.488758553274685,4,1
2017,152,1314,77,1332,76,1,3,0.7878787878787878,13.424242424242426,0.8484848484848485,13.303030303030303,-2,-0.06060606060606066,0.12121212121212288,1,1
2017,154,1314,71,1211,65,1,1,0.7878787878787878,13.424242424242426,0.9696969696969697,23.424242424242426,0,-0.18181818181818188,-10.0,6,1
2018,134,1347,71,1254,61,16,16,0.625,2.0625,0.5151515151515151,-0.12121212121212122,0,0.10984848484848486,2.183712121212121,10,1
2018,134,1382,65,1417,58,11,11,0.78125,6.90625,0.65625,5.59375,0,0.125,1.3125,7,1
2018,135,1393,60,1113,56,11,11,0.6060606060606061,3.0,0.6451612903225806,8.193548387096774,0,-0.03910068426197455,-5.193548387096774,4,1
2018,135,1411,64,1300,46,16,16,0.4411764705882353,-2.088235294117647,0.5161290322580645,-0.3225806451612903,0,-0.07495256166982922,-1.765654648956357,18,1
2018,136,1104,86,1439,83,9,8,0.5588235294117647,2.3823529411764706,0.65625,7.968750000000002,1,-0.09742647058823528,-5.586397058823531,3,1
2018,136,1138,89,1112,68,13,4,0.7575757575757576,8.181818181818182,0.7941176470588235,9.705882352941176,9,-0.036541889483065915,-1.524064171122994,21,1
2018,136,1181,89,1233,67,2,15,0.7878787878787878,15.090909090909092,0.6060606060606061,3.696969696969697,-13,0.18181818181818177,11.393939393939394,22,1
2018,136,1196,77,1382,62,6,11,0.625,6.625,0.78125,6.90625,-5,-0.15625,-0.28125,15,1
2018,136,1211,68,1422,64,4,13,0.8823529411764706,17.38235294117647,0.7741935483870968,8.806451612903226,-9,0.10815939278937381,8.575901328273245,4,1
2018,136,1222,67,1361,65,6,11,0.7878787878787878,12.515151515151516,0.6774193548387096,8.64516129032258,-5,0.11045943304007821,3.8699902248289355,2,1
2018,136,1242,76,1335,60,1,16,0.7941176470588235,10.558823529411763,0.7419354838709677,6.096774193548387,-15,0.052182163187855735,4.462049335863376,16,1
2018,136,1246,78,1172,73,5,12,0.7058823529411765,6.4411764705882355,0.65625,8.875,-7,0.049632352941176516,-2.4338235294117645,5,1
2018,136,1260,64,1274,62,11,6,0.84375,9.65625,0.7096774193548387,6.129032258064516,5,0.13407258064516125,3.527217741935484,2,1
2018,136,1276,61,1285,47,3,14,0.7941176470588235,10.117647058823529,0.7741935483870968,9.258064516129032,-11,0.01992409867172673,0.859582542694497,14,1
2018,136,1326,81,1355,73,5,12,0.75,9.125,0.8,7.733333333333333,-7,-0.050000000000000044,1.3916666666666666,8,1
2018,136,1348,83,1328,78,7,10,0.78125,8.28125,0.5806451612903226,3.5161290322580645,-3,0.20060483870967738,4.765120967741936,5,1
2018,136,1371,94,1301,83,8,9,0.65625,5.6875,0.65625,6.75,-1,0.0,-1.0625,11,1
2018,136,1397,73,1460,47,3,14,0.7575757575757576,7.818181818181818,0.71875,5.15625,-11,0.03882575757575757,2.6619318181818183,26,1
2018,136,1403,70,1372,60,3,14,0.7272727272727273,10.545454545454545,0.8,9.766666666666667,-11,-0.07272727272727275,0.7787878787878775,10,1
2018,136,1437,87,1347,61,1,16,0.8823529411764706,16.176470588235293,0.625,2.0625,-15,0.25735294117647056,14.113970588235293,26,1
2018,137,1120,62,1158,58,4,13,0.78125,10.0625,0.7741935483870968,5.419354838709677,-9,0.007056451612903247,4.643145161290323,4,1
2018,137,1139,79,1116,62,10,7,0.6060606060606061,6.333333333333333,0.6764705882352942,5.5588235294117645,3,-0.07040998217468808,0.7745098039215685,17,1
2018,137,1153,68,1209,53,2,15,0.8823529411764706,17.323529411764707,0.6875,6.65625,-13,0.19485294117647056,10.667279411764707,15,1
2018,137,1155,79,1308,68,5,12,0.71875,7.46875,0.8333333333333334,10.866666666666667,-7,-0.11458333333333337,-3.397916666666667,11,1
2018,137,1199,67,1281,54,9,8,0.6451612903225806,7.290322580645161,0.6129032258064516,5.193548387096774,1,0.032258064516129004,2.096774193548387,13,1
2018,137,1243,69,1166,59,9,8,0.6666666666666666,4.484848484848484,0.6451612903225806,8.838709677419354,1,0.021505376344086002,-4.35386119257087,10,1
2018,137,1267,81,1455,75,13,4,0.696969696969697,4.515151515151516,0.78125,11.65625,9,-0.08428030303030298,-7.141098484848484,6,1
2018,137,1277,82,1137,78,3,14,0.8787878787878788,16.181818181818183,0.7352941176470589,8.294117647058824,-11,0.1434937611408199,7.887700534759359,4,1
2018,137,1305,87,1400,83,7,10,0.7941176470588235,10.205882352941176,0.5757575757575758,3.5151515151515147,-3,0.21836007130124768,6.690730837789661,4,1
2018,137,1314,84,1252,66,2,15,0.7142857142857143,8.857142857142858,0.6896551724137931,2.3793103448275863,-13,0.024630541871921152,6.477832512315271,18,1
2018,137,1345,74,1168,48,2,15,0.8235294117647058,15.5,0.6206896551724138,1.0,-13,0.20283975659229203,14.5,26,1
2018,137,1393,57,1395,52,11,6,0.6060606060606061,3.0,0.65625,7.0625,5,-0.05018939393939392,-4.0625,5,1
2018,137,1401,73,1344,69,7,10,0.625,5.1875,0.6176470588235294,1.0294117647058822,-3,0.007352941176470562,4.158088235294118,4,1
2018,137,1420,74,1438,54,16,1,0.6774193548387096,1.5161290322580645,0.9393939393939394,14.151515151515152,15,-0.2619745845552298,-12.635386119257088,20,1
2018,137,1452,85,1293,68,5,12,0.7058823529411765,10.617647058823529,0.8275862068965517,11.344827586206897,-7,-0.1217038539553752,-0.7271805273833678,17,1
2018,137,1462,102,1411,83,1,16,0.8484848484848485,9.787878787878787,0.4411764705882353,-2.088235294117647,-15,0.4073083778966132,11.876114081996434,19,1
2018,138,1181,87,1348,62,2,7,0.7878787878787878,15.090909090909092,0.78125,8.28125,-5,0.006628787878787845,6.809659090909092,25,1
2018,138,1211,90,1326,84,4,5,0.8823529411764706,17.38235294117647,0.75,9.125,-1,0.13235294117647056,8.257352941176471,6,1
2018,138,1242,83,1371,79,1,8,0.7941176470588235,10.558823529411763,0.65625,5.6875,-7,0.13786764705882348,4.871323529411763,4,1
2018,138,1246,95,1138,75,5,13,0.7058823529411765,6.4411764705882355,0.7575757575757576,8.181818181818182,-8,-0.05169340463458105,-1.7406417112299462,20,1
2018,138,1260,63,1397,62,11,3,0.84375,9.65625,0.7575757575757576,7.818181818181818,8,0.08617424242424243,1.8380681818181817,1,1
2018,138,1276,64,1222,63,3,6,0.7941176470588235,10.117647058823529,0.7878787878787878,12.515151515151516,-3,0.0062388591800356386,-2.3975044563279866,1,1
2018,138,1403,69,1196,66,3,6,0.7272727272727273,10.545454545454545,0.625,6.625,-3,0.10227272727272729,3.920454545454545,3,1
2018,138,1437,81,1104,58,1,9,0.8823529411764706,16.176470588235293,0.5588235294117647,2.3823529411764706,-8,0.32352941176470584,13.794117647058822,23,1
2018,139,1155,84,1120,53,5,4,0.71875,7.46875,0.78125,10.0625,1,-0.0625,-2.59375,31,1
2018,139,1199,75,1462,70,9,1,0.6451612903225806,7.290322580645161,0.8484848484848485,9.787878787878787,8,-0.20332355816226788,-2.497556207233626,5,1
2018,139,1243,50,1420,43,9,16,0.6666666666666666,4.484848484848484,0.6774193548387096,1.5161290322580645,-7,-0.010752688172043001,2.96871945259042,7,1
2018,139,1305,75,1153,73,7,2,0.7941176470588235,10.205882352941176,0.8823529411764706,17.323529411764707,5,-0.08823529411764708,-7.117647058823531,2,1
2018,139,1345,76,1139,73,2,10,0.8235294117647058,15.5,0.6060606060606061,6.333333333333333,-8,0.21746880570409977,9.166666666666668,3,1
2018,139,1393,55,1277,53,11,3,0.6060606060606061,3.0,0.8787878787878788,16.181818181818183,8,-0.2727272727272727,-13.181818181818183,2,1
2018,139,1401,86,1314,65,7,2,0.625,5.1875,0.7142857142857143,8.857142857142858,5,-0.0892857142857143,-3.6696428571428577,21,1
2018,139,1452,94,1267,71,5,13,0.7058823529411765,10.617647058823529,0.696969696969697,4.515151515151516,-8,0.0089126559714795,6.102495543672013,23,1
2018,143,1199,75,1211,60,9,4,0.6451612903225806,7.290322580645161,0.8823529411764706,17.38235294117647,5,-0.23719165085388993,-10.09203036053131,15,1
2018,143,1243,61,1246,58,9,5,0.6666666666666666,4.484848484848484,0.7058823529411765,6.4411764705882355,4,-0.03921568627450989,-1.956327985739751,3,1
2018,143,1260,69,1305,68,11,7,0.84375,9.65625,0.7941176470588235,10.205882352941176,4,0.049632352941176516,-0.5496323529411757,1,1
2018,143,1276,99,1401,72,3,7,0.7941176470588235,10.117647058823529,0.625,5.1875,-4,0.16911764705882348,4.930147058823529,27,1
2018,144,1181,69,1393,65,2,11,0.7878787878787878,15.090909090909092,0.6060606060606061,3.0,-9,0.18181818181818177,12.090909090909092,4,1
2018,144,1242,80,1155,76,1,5,0.7941176470588235,10.558823529411763,0.71875,7.46875,-4,0.07536764705882348,3.0900735294117627,4,1
2018,144,1403,78,1345,65,3,2,0.7272727272727273,10.545454545454545,0.8235294117647058,15.5,1,-0.09625668449197855,-4.954545454545455,13,1
2018,144,1437,90,1452,78,1,5,0.8823529411764706,16.176470588235293,0.7058823529411765,10.617647058823529,-4,0.17647058823529405,5.5588235294117645,12,1
2018,145,1260,78,1243,62,11,9,0.84375,9.65625,0.6666666666666666,4.484848484848484,2,0.17708333333333337,5.171401515151516,16,1
2018,145,1276,58,1199,54,3,9,0.7941176470588235,10.117647058823529,0.6451612903225806,7.290322580645161,-6,0.14895635673624286,2.827324478178368,4,1
2018,146,1242,85,1181,81,1,2,0.7941176470588235,10.558823529411763,0.7878787878787878,15.090909090909092,-1,0.0062388591800356386,-4.532085561497329,4,1
2018,146,1437,71,1403,59,1,3,0.8823529411764706,16.176470588235293,0.7272727272727273,10.545454545454545,-2,0.15508021390374327,5.6310160427807485,12,1
2018,152,1276,69,1260,57,3,11,0.7941176470588235,10.117647058823529,0.84375,9.65625,-8,-0.049632352941176516,0.461397058823529,12,1
2018,152,1437,95,1242,79,1,1,0.8823529411764706,16.176470588235293,0.7941176470588235,10.558823529411763,0,0.08823529411764708,5.617647058823531,16,1
2018,154,1437,79,1276,62,1,3,0.8823529411764706,16.176470588235293,0.7941176470588235,10.117647058823529,-2,0.08823529411764708,6.0588235294117645,17,1
2019,134,1125,81,1396,70,11,11,0.8333333333333334,12.2,0.71875,3.6875,0,0.11458333333333337,8.5125,11,1
2019,134,1192,82,1341,76,16,16,0.5806451612903226,2.2580645161290325,0.6363636363636364,2.121212121212121,0,-0.055718475073313734,0.13685239491691137,6,1
2019,135,1113,74,1385,65,11,11,0.6875,4.75,0.6363636363636364,2.727272727272727,0,0.051136363636363646,2.022727272727273,9,1
2019,135,1295,78,1300,74,16,16,0.5161290322580645,-1.4516129032258065,0.5,-0.16666666666666666,0,0.016129032258064502,-1.2849462365591398,4,1
2019,136,1120,78,1308,77,5,12,0.7352941176470589,10.294117647058824,0.875,12.84375,-7,-0.13970588235294112,-2.5496323529411757,1,1
2019,136,1124,78,1393,69,9,8,0.59375,4.46875,0.6060606060606061,4.03030303030303,1,-0.012310606060606077,0.4384469696969697,9,1
2019,136,1196,70,1305,61,10,7,0.5588235294117647,4.617647058823529,0.8787878787878788,14.0,3,-0.31996434937611407,-9.382352941176471,9,1
2019,136,1199,76,1436,69,4,13,0.7941176470588235,7.794117647058823,0.8125,9.5625,-9,-0.018382352941176516,-1.7683823529411766,7,1
2019,136,1211,87,1192,49,1,16,0.9090909090909091,23.78787878787879,0.5806451612903226,2.2580645161290325,-15,0.32844574780058644,21.529814271749757,38,1
2019,136,1242,87,1318,53,4,13,0.7352941176470589,5.294117647058823,0.696969696969697,5.818181818181818,-9,0.03832442067736186,-0.524064171122995,34,1
2019,136,1246,79,1101,44,2,15,0.8181818181818182,11.303030303030303,0.7931034482758621,6.827586206896552,-13,0.025078369905956133,4.475444096133751,35,1
2019,136,1261,79,1463,74,3,14,0.8125,8.34375,0.75,7.178571428571429,-11,0.0625,1.1651785714285712,5,1
2019,136,1268,79,1125,77,6,11,0.6875,6.28125,0.8333333333333334,12.2,-5,-0.14583333333333337,-5.918749999999999,2,1
2019,136,1276,74,1285,55,2,15,0.8235294117647058,11.823529411764708,0.75,7.34375,-13,0.07352941176470584,4.479779411764708,19,1
2019,136,1277,76,1133,65,2,15,0.8235294117647058,13.294117647058822,0.5757575757575758,1.181818181818181,-13,0.24777183600713004,12.11229946524064,11,1
2019,136,1278,86,1257,76,10,7,0.6176470588235294,1.6176470588235294,0.6060606060606061,6.7272727272727275,3,0.01158645276292336,-5.109625668449198,10,1
2019,136,1293,83,1266,64,12,5,0.8620689655172413,13.206896551724135,0.7272727272727273,8.636363636363637,7,0.13479623824451403,4.5705329153604985,19,1
2019,136,1345,61,1330,48,3,14,0.71875,9.375000000000002,0.7647058823529411,5.323529411764706,-11,-0.045955882352941124,4.051470588235296,13,1
2019,136,1437,61,1388,57,6,11,0.7352941176470589,7.382352941176471,0.6666666666666666,8.545454545454545,-5,0.06862745098039225,-1.163101604278074,4,1
2019,136,1459,84,1371,68,7,10,0.8666666666666667,13.666666666666666,0.6060606060606061,2.4545454545454546,-3,0.2606060606060606,11.212121212121211,16,1
2019,137,1138,91,1113,74,6,11,0.9090909090909091,13.818181818181818,0.6875,4.75,-5,0.22159090909090906,9.068181818181818,17,1
2019,137,1181,85,1295,62,1,16,0.8529411764705882,15.941176470588236,0.5161290322580645,-1.4516129032258065,-15,0.3368121442125237,17.392789373814043,23,1
2019,137,1222,84,1209,55,3,14,0.9117647058823529,14.382352941176473,0.71875,2.75,-11,0.19301470588235292,11.632352941176473,29,1
2019,137,1234,79,1153,72,10,7,0.6666666666666666,4.666666666666667,0.8235294117647058,9.5,3,-0.1568627450980392,-4.833333333333333,7,1
2019,137,1251,80,1280,76,12,5,0.8064516129032258,9.903225806451612,0.696969696969697,7.212121212121212,7,0.10948191593352874,2.6911045943304,4,1
2019,137,1314,88,1233,73,1,16,0.8181818181818182,13.121212121212123,0.53125,1.21875,-15,0.28693181818181823,11.902462121212123,15,1
2019,137,1326,62,1235,59,11,6,0.5757575757575758,3.4242424242424243,0.6764705882352942,9.117647058823529,5,-0.10071301247771836,-5.693404634581105,3,1
2019,137,1328,95,1279,72,9,8,0.59375,2.9375,0.625,5.03125,1,-0.03125,-2.09375,23,1
2019,137,1332,72,1458,54,12,5,0.6571428571428571,7.542857142857143,0.696969696969697,7.636363636363637,7,-0.03982683982683988,-0.09350649350649398,18,1
2019,137,1397,77,1159,70,2,15,0.8484848484848485,12.181818181818182,0.696969696969697,5.424242424242424,-13,0.1515151515151515,6.757575757575758,7,1
2019,137,1403,72,1297,57,3,14,0.8125,13.8125,0.75,7.75,-11,0.0625,6.0625,15,1
2019,137,1414,70,1243,64,13,4,0.8529411764705882,8.852941176470589,0.7575757575757576,6.575757575757576,9,0.09536541889483063,2.2771836007130126,6,1
2019,137,1416,73,1433,58,9,8,0.7419354838709677,7.838709677419355,0.78125,9.84375,1,-0.03931451612903225,-2.005040322580645,15,1
2019,137,1438,71,1205,56,1,16,0.90625,16.78125,0.6451612903225806,2.3548387096774195,-15,0.2610887096774194,14.42641129032258,15,1
2019,137,1439,66,1387,52,4,13,0.75,11.90625,0.6571428571428571,3.3142857142857136,-9,0.09285714285714286,8.591964285714287,14,1
2019,137,1449,78,1429,61,9,8,0.7647058823529411,5.4411764705882355,0.8181818181818182,11.93939393939394,1,-0.05347593582887711,-6.498217468805704,17,1
2019,138,1120,89,1242,75,5,4,0.7352941176470589,10.294117647058824,0.7352941176470589,5.294117647058823,1,0.0,5.000000000000001,14,1
2019,138,1199,90,1293,62,4,12,0.7941176470588235,7.794117647058823,0.8620689655172413,13.206896551724135,-8,-0.06795131845841784,-5.412778904665312,28,1
2019,138,1211,83,1124,71,1,9,0.9090909090909091,23.78787878787879,0.59375,4.46875,-8,0.31534090909090906,19.31912878787879,12,1
2019,138,1246,62,1459,56,2,7,0.8181818181818182,11.303030303030303,0.8666666666666667,13.666666666666666,-5,-0.048484848484848464,-2.3636363636363633,6,1
2019,138,1261,69,1268,67,3,6,0.8125,8.34375,0.6875,6.28125,-3,0.125,2.0625,2,1
2019,138,1276,64,1196,49,2,10,0.8235294117647058,11.823529411764708,0.5588235294117647,4.617647058823529,-8,0.2647058823529411,7.205882352941179,15,1
2019,138,1277,70,1278,50,2,10,0.8235294117647058,13.294117647058822,0.6176470588235294,1.6176470588235294,-8,0.2058823529411764,11.676470588235293,20,1
2019,138,1345,87,1437,61,3,6,0.71875,9.375000000000002,0.7352941176470589,7.382352941176471,-3,-0.016544117647058876,1.9926470588235308,26,1
2019,139,1181,77,1416,76,1,9,0.8529411764705882,15.941176470588236,0.7419354838709677,7.838709677419355,-8,0.11100569259962045,8.10246679316888,1,1
2019,139,1222,74,1326,59,3,11,0.9117647058823529,14.382352941176473,0.5757575757575758,3.4242424242424243,-8,0.3360071301247771,10.958110516934049,15,1
2019,139,1314,81,1449,59,1,9,0.8181818181818182,13.121212121212123,0.7647058823529411,5.4411764705882355,-8,0.05347593582887711,7.680035650623887,22,1
2019,139,1332,73,1414,54,12,13,0.6571428571428571,7.542857142857143,0.8529411764705882,8.852941176470589,-1,-0.19579831932773106,-1.310084033613446,19,1
2019,139,1397,83,1234,77,2,10,0.8484848484848485,12.181818181818182,0.6666666666666666,4.666666666666667,-8,0.18181818181818188,7.515151515151515,6,1
2019,139,1403,78,1138,58,3,6,0.8125,13.8125,0.9090909090909091,13.818181818181818,-3,-0.09659090909090906,-0.005681818181818343,20,1
2019,139,1438,63,1328,51,1,9,0.90625,16.78125,0.59375,2.9375,-8,0.3125,13.84375,12,1
2019,139,1439,67,1251,58,4,12,0.75,11.90625,0.8064516129032258,9.903225806451612,-8,-0.056451612903225756,2.003024193548388,9,1
2019,143,1211,72,1199,58,1,4,0.9090909090909091,23.78787878787879,0.7941176470588235,7.794117647058823,-3,0.11497326203208558,15.993761140819966,14,1
2019,143,1345,99,1397,94,3,2,0.71875,9.375000000000002,0.8484848484848485,12.181818181818182,1,-0.1297348484848485,-2.80681818181818,5,1
2019,143,1403,63,1276,44,3,2,0.8125,13.8125,0.8235294117647058,11.823529411764708,1,-0.011029411764705843,1.9889705882352917,19,1
2019,143,1438,53,1332,49,1,12,0.90625,16.78125,0.6571428571428571,7.542857142857143,-11,0.24910714285714286,9.238392857142857,4,1
2019,144,1120,97,1314,80,5,1,0.7352941176470589,10.294117647058824,0.8181818181818182,13.121212121212123,4,-0.08288770053475936,-2.8270944741532986,17,1
2019,144,1181,75,1439,73,1,4,0.8529411764705882,15.941176470588236,0.75,11.90625,-3,0.1029411764705882,4.0349264705882355,2,1
2019,144,1246,62,1222,58,2,3,0.8181818181818182,11.303030303030303,0.9117647058823529,14.382352941176473,-1,-0.09358288770053469,-3.07932263814617,4,1
2019,144,1277,80,1261,63,2,3,0.8235294117647058,13.294117647058822,0.8125,8.34375,-1,0.011029411764705843,4.9503676470588225,17,1
2019,145,1403,75,1211,69,3,1,0.8125,13.8125,0.9090909090909091,23.78787878787879,2,-0.09659090909090906,-9.975378787878789,6,1
2019,145,1438,80,1345,75,1,3,0.90625,16.78125,0.71875,9.375000000000002,-2,0.1875,7.406249999999998,5,1
2019,146,1120,77,1246,71,5,2,0.7352941176470589,10.294117647058824,0.8181818181818182,11.303030303030303,3,-0.08288770053475936,-1.0089126559714785,6,1
2019,146,1277,68,1181,67,2,1,0.8235294117647058,13.294117647058822,0.8529411764705882,15.941176470588236,1,-0.02941176470588236,-2.647058823529413,1,1
2019,152,1403,61,1277,51,3,2,0.8125,13.8125,0.8235294117647058,13.294117647058822,1,-0.011029411764705843,0.5183823529411775,10,1
2019,152,1438,63,1120,62,1,5,0.90625,16.78125,0.7352941176470589,10.294117647058824,-4,0.17095588235294112,6.487132352941176,1,1
2019,154,1438,85,1403,77,1,3,0.90625,16.78125,0.8125,13.8125,-2,0.09375,2.96875,8,1
2021,136,1179,53,1455,52,11,11,0.8518518518518519,11.185185185185185,0.7368421052631579,2.6315789473684212,0,0.115009746588694,8.553606237816764,1,1
2021,136,1313,54,1111,53,16,16,0.6666666666666666,4.571428571428571,0.5416666666666666,-0.08333333333333275,0,0.125,4.654761904761904,1,1
2021,136,1411,60,1291,52,16,16,0.6521739130434783,3.4782608695652173,0.5454545454545454,1.4090909090909092,0,0.10671936758893286,2.069169960474308,8,1
2021,136,1417,86,1277,80,11,11,0.6538461538461539,4.346153846153846,0.5555555555555556,-1.5185185185185186,0,0.09829059829059827,5.864672364672364,6,1
2021,137,1116,85,1159,68,3,14,0.7857142857142857,11.714285714285714,0.9333333333333333,17.733333333333334,-11,-0.14761904761904765,-6.019047619047621,17,1
2021,137,1124,79,1216,55,1,16,0.9166666666666666,17.958333333333332,0.6521739130434783,2.608695652173913,-15,0.26449275362318836,15.349637681159418,24,1
2021,137,1196,75,1439,70,7,10,0.6086956521739131,4.130434782608695,0.7142857142857143,6.619047619047619,-3,-0.10559006211180122,-2.4886128364389233,5,1
2021,137,1222,87,1156,56,2,15,0.8846153846153846,18.0,0.7307692307692307,0.8846153846153846,-13,0.15384615384615385,17.115384615384617,31,1
2021,137,1228,78,1180,49,1,16,0.7931034482758621,12.172413793103448,0.631578947368421,4.631578947368421,-15,0.16152450090744108,7.540834845735027,29,1
2021,137,1260,71,1210,60,8,9,0.8461538461538461,14.692307692307692,0.68,5.52,-1,0.1661538461538461,9.172307692307692,11,1
2021,137,1317,78,1345,69,13,4,0.64,7.64,0.6666666666666666,4.814814814814815,9,-0.026666666666666616,2.825185185185185,9,1
2021,137,1329,69,1251,60,4,13,0.7142857142857143,4.178571428571429,0.7916666666666666,11.0,-9,-0.07738095238095233,-6.821428571428571,9,1
2021,137,1331,75,1326,72,15,2,0.5652173913043478,1.826086956521739,0.7,6.366666666666666,13,-0.13478260869565217,-4.540579710144927,3,1
2021,137,1333,70,1397,56,12,5,0.5714285714285714,-0.14285714285714285,0.6923076923076923,9.26923076923077,7,-0.1208791208791209,-9.412087912087912,14,1
2021,137,1353,60,1155,56,10,7,0.5769230769230769,1.7307692307692308,0.6956521739130435,3.3043478260869565,3,-0.11872909698996659,-1.5735785953177257,4,1
2021,137,1393,78,1361,62,11,6,0.64,5.12,0.8461538461538461,12.423076923076923,5,-0.20615384615384613,-7.303076923076923,16,1
2021,137,1403,65,1429,53,6,11,0.6296296296296297,9.62962962962963,0.7037037037037037,10.481481481481481,-5,-0.07407407407407407,-0.8518518518518512,12,1
2021,137,1437,73,1457,63,5,12,0.7272727272727273,8.409090909090908,0.9583333333333334,12.75,-7,-0.23106060606060608,-4.340909090909092,10,1
2021,137,1452,84,1287,67,3,14,0.6666666666666666,5.185185185185185,0.75,4.107142857142857,-11,-0.08333333333333337,1.0780423280423284,17,1
2021,137,1458,85,1314,62,9,8,0.5862068965517241,5.310344827586207,0.6428571428571429,6.285714285714286,1,-0.05665024630541882,-0.9753694581280783,23,1
2021,138,1101,53,1400,52,14,3,0.8260869565217391,14.565217391304348,0.7307692307692307,6.423076923076923,11,0.09531772575250841,8.142140468227424,1,1
2021,138,1104,68,1233,55,2,15,0.8,9.8,0.7058823529411765,6.294117647058823,-13,0.09411764705882353,3.5058823529411773,13,1
2021,138,1160,96,1207,73,5,12,0.7333333333333333,9.766666666666667,0.52,0.68,-7,0.21333333333333326,9.086666666666668,23,1
2021,138,1166,63,1364,62,5,12,0.7142857142857143,8.678571428571429,0.8333333333333334,10.333333333333334,-7,-0.11904761904761907,-1.654761904761905,1,1
2021,138,1199,64,1422,54,4,13,0.7272727272727273,8.590909090909092,0.7241379310344828,6.172413793103448,-9,0.0031347962382445305,2.4184952978056433,10,1
2021,138,1211,98,1313,55,1,16,1.0,23.0,0.6666666666666666,4.571428571428571,-15,0.33333333333333337,18.42857142857143,43,1
2021,138,1234,86,1213,74,2,15,0.7241379310344828,11.827586206896552,0.7,9.6,-13,0.024137931034482807,2.227586206896552,12,1
2021,138,1242,93,1186,84,3,14,0.7037037037037037,6.333333333333333,0.6818181818181818,7.909090909090909,-11,0.021885521885521952,-1.5757575757575761,9,1
2021,138,1261,76,1382,61,8,9,0.6666666666666666,6.777777777777778,0.8,10.15,-1,-0.13333333333333341,-3.3722222222222227,15,1
2021,138,1268,63,1163,54,10,7,0.5357142857142857,2.4642857142857144,0.6818181818181818,7.909090909090909,3,-0.14610389610389607,-5.444805194805195,9,1
2021,138,1276,82,1411,66,1,16,0.8333333333333334,10.875,0.6521739130434783,3.4782608695652173,-15,0.1811594202898551,7.396739130434783,16,1
2021,138,1325,62,1438,58,13,4,0.6818181818181818,7.045454545454544,0.75,8.166666666666666,9,-0.06818181818181823,-1.121212121212122,4,1
2021,138,1328,72,1281,68,8,9,0.6,5.52,0.64,1.72,-1,-0.040000000000000036,3.8,4,1
2021,138,1417,73,1140,62,11,6,0.6538461538461539,4.346153846153846,0.76,8.72,5,-0.10615384615384615,-4.373846153846155,11,1
2021,138,1425,72,1179,56,6,11,0.7586206896551724,9.655172413793103,0.8518518518518519,11.185185185185185,-5,-0.09323116219667948,-1.530012771392082,16,1
2021,139,1116,68,1403,66,3,6,0.7857142857142857,11.714285714285714,0.6296296296296297,9.62962962962963,-3,0.15608465608465605,2.0846560846560838,2,1
2021,139,1124,76,1458,63,1,9,0.9166666666666666,17.958333333333332,0.5862068965517241,5.310344827586207,-8,0.33045977011494254,12.647988505747126,13,1
2021,139,1222,63,1353,60,2,10,0.8846153846153846,18.0,0.5769230769230769,1.7307692307692308,-8,0.3076923076923077,16.26923076923077,3,1
2021,139,1260,71,1228,58,8,1,0.8461538461538461,14.692307692307692,0.7931034482758621,12.172413793103448,7,0.053050397877984046,2.5198938992042432,13,1
2021,139,1331,81,1196,78,15,7,0.5652173913043478,1.826086956521739,0.6086956521739131,4.130434782608695,8,-0.0434782608695653,-2.304347826086956,3,1
2021,139,1333,80,1329,70,12,4,0.5714285714285714,-0.14285714285714285,0.7142857142857143,4.178571428571429,8,-0.1428571428571429,-4.321428571428572,10,1
2021,139,1393,75,1452,72,11,3,0.64,5.12,0.6666666666666666,5.185185185185185,8,-0.026666666666666616,-0.06518518518518501,3,1
2021,139,1437,84,1317,61,5,13,0.7272727272727273,8.409090909090908,0.64,7.64,-8,0.08727272727272728,0.7690909090909086,23,1
2021,140,1104,96,1268,77,2,10,0.8,9.8,0.5357142857142857,2.4642857142857144,-8,0.26428571428571435,7.335714285714286,19,1
2021,140,1166,72,1325,58,5,13,0.7142857142857143,8.678571428571429,0.6818181818181818,7.045454545454544,-8,0.032467532467532534,1.6331168831168847,14,1
2021,140,1199,71,1160,53,4,5,0.7272727272727273,8.590909090909092,0.7333333333333333,9.766666666666667,-1,-0.006060606060605989,-1.1757575757575758,18,1
2021,140,1211,87,1328,71,1,8,1.0,23.0,0.6,5.52,-7,0.4,17.48,16,1
2021,140,1276,86,1261,78,1,8,0.8333333333333334,10.875,0.6666666666666666,6.777777777777778,-7,0.16666666666666674,4.097222222222222,8,1
2021,140,1332,95,1234,80,7,2,0.7692307692307693,6.961538461538462,0.7241379310344828,11.827586206896552,5,0.04509283819628651,-4.86604774535809,15,1
2021,140,1417,67,1101,47,11,14,0.6538461538461539,4.346153846153846,0.8260869565217391,14.565217391304348,-3,-0.17224080267558528,-10.219063545150501,20,1
2021,140,1425,85,1242,51,6,3,0.7586206896551724,9.655172413793103,0.7037037037037037,6.333333333333333,3,0.054916985951468655,3.32183908045977,34,1
2021,145,1116,72,1331,70,3,15,0.7857142857142857,11.714285714285714,0.5652173913043478,1.826086956521739,-12,0.22049689440993792,9.888198757763975,2,1
2021,145,1124,62,1437,51,1,5,0.9166666666666666,17.958333333333332,0.7272727272727273,8.409090909090908,-4,0.18939393939393934,9.549242424242424,11,1
2021,145,1222,62,1393,46,2,11,0.8846153846153846,18.0,0.64,5.12,-9,0.24461538461538457,12.879999999999999,16,1
2021,145,1333,65,1260,58,12,8,0.5714285714285714,-0.14285714285714285,0.8461538461538461,14.692307692307692,4,-0.27472527472527475,-14.835164835164834,7,1
2021,146,1211,83,1166,65,1,5,1.0,23.0,0.7142857142857143,8.678571428571429,-4,0.2857142857142857,14.321428571428571,18,1
2021,146,1276,76,1199,58,1,4,0.8333333333333334,10.875,0.7272727272727273,8.590909090909092,-3,0.10606060606060608,2.2840909090909083,18,1
2021,146,1417,88,1104,78,11,2,0.6538461538461539,4.346153846153846,0.8,9.8,9,-0.1461538461538462,-5.453846153846155,10,1
2021,146,1425,82,1332,68,6,7,0.7586206896551724,9.655172413793103,0.7692307692307693,6.961538461538462,-1,-0.010610079575596898,2.6936339522546415,14,1
2021,147,1124,81,1116,72,1,3,0.9166666666666666,17.958333333333332,0.7857142857142857,11.714285714285714,-2,0.13095238095238093,6.244047619047619,9,1
2021,147,1222,67,1333,61,2,12,0.8846153846153846,18.0,0.5714285714285714,-0.14285714285714285,-10,0.3131868131868132,18.142857142857142,6,1
2021,148,1211,85,1425,66,1,6,1.0,23.0,0.7586206896551724,9.655172413793103,-5,0.24137931034482762,13.344827586206897,19,1
2021,148,1417,51,1276,49,11,1,0.6538461538461539,4.346153846153846,0.8333333333333334,10.875,10,-0.17948717948717952,-6.528846153846154,2,1
2021,152,1124,78,1222,59,1,2,0.9166666666666666,17.958333333333332,0.8846153846153846,18.0,-1,0.03205128205128205,-0.04166666666666785,19,1
2021,152,1211,93,1417,90,1,11,1.0,23.0,0.6538461538461539,4.346153846153846,-10,0.34615384615384615,18.653846153846153,3,1
2021,154,1124,86,1211,70,1,1,0.9166666666666666,17.958333333333332,1.0,23.0,0,-0.08333333333333337,-5.041666666666668,16,1
2022,134,1231,66,1461,58,12,12,0.6060606060606061,5.545454545454546,0.75,6.1875,0,-0.14393939393939392,-0.6420454545454541,8,1
2022,134,1411,76,1394,67,16,16,0.6,3.7333333333333334,0.6333333333333333,2.7000000000000006,0,-0.033333333333333326,1.0333333333333328,9,1
2022,135,1323,89,1353,87,11,11,0.6774193548387096,5.0,0.5806451612903226,2.0967741935483866,0,0.09677419354838701,2.9032258064516134,2,1
2022,135,1460,93,1136,82,16,16,0.6060606060606061,3.5454545454545454,0.7,3.0666666666666655,0,-0.09393939393939388,0.4787878787878799,11,1
2022,136,1116,75,1436,71,4,13,0.7575757575757576,8.393939393939394,0.84375,14.062500000000002,-9,-0.08617424242424243,-5.668560606060607,4,1
2022,136,1124,85,1313,49,1,16,0.8125,12.875,0.7777777777777778,6.925925925925926,-15,0.03472222222222221,5.949074074074074,36,1
2022,136,1166,72,1361,69,9,8,0.6666666666666666,3.090909090909091,0.7419354838709677,7.612903225806452,1,-0.07526881720430112,-4.521994134897361,3,1
2022,136,1211,93,1209,72,1,16,0.896551724137931,22.482758620689655,0.6,1.08,-15,0.29655172413793107,21.402758620689653,21,1
2022,136,1242,83,1411,56,1,16,0.8235294117647058,10.441176470588236,0.6,3.7333333333333334,-15,0.22352941176470587,6.707843137254902,27,1
2022,136,1272,64,1129,53,9,8,0.6774193548387096,7.032258064516129,0.7878787878787878,7.242424242424242,1,-0.11045943304007821,-0.2101661779081132,11,1
2022,136,1276,75,1161,63,11,6,0.5483870967741935,3.161290322580645,0.8275862068965517,7.379310344827586,5,-0.2791991101223582,-4.218020022246941,12,1
2022,136,1293,92,1362,87,7,10,0.9310344827586207,14.0,0.71875,9.3125,-3,0.21228448275862066,4.6875,5,1
2022,136,1308,70,1163,63,12,5,0.7931034482758621,6.206896551724138,0.71875,10.03125,7,0.0743534482758621,-3.824353448275862,7,1
2022,136,1314,95,1266,63,8,9,0.7272727272727273,5.787878787878788,0.6129032258064516,3.5161290322580645,-1,0.11436950146627567,2.2717497556207236,32,1
2022,136,1344,66,1355,57,4,13,0.8333333333333334,4.799999999999999,0.875,10.96875,-9,-0.04166666666666663,-6.168750000000001,9,1
2022,136,1350,67,1234,63,12,5,0.6571428571428571,3.4285714285714284,0.7428571428571429,12.485714285714286,7,-0.08571428571428574,-9.057142857142857,4,1
2022,136,1388,82,1231,53,5,12,0.7741935483870968,8.35483870967742,0.6060606060606061,5.545454545454546,-7,0.16813294232649068,2.809384164222874,29,1
2022,136,1389,85,1246,79,15,2,0.6206896551724138,3.9310344827586206,0.7878787878787878,13.454545454545455,13,-0.16718913270637403,-9.523510971786834,6,1
2022,136,1397,88,1255,56,3,14,0.7878787878787878,10.424242424242424,0.7857142857142857,7.178571428571429,-11,0.0021645021645021467,3.245670995670995,32,1
2022,136,1417,57,1103,53,4,13,0.78125,11.5625,0.7096774193548387,5.129032258064516,-9,0.07157258064516125,6.433467741935484,4,1
2022,137,1112,87,1460,70,1,16,0.9117647058823529,17.029411764705884,0.6060606060606061,3.5454545454545454,-15,0.30570409982174684,13.483957219251339,17,1
2022,137,1120,80,1240,61,2,15,0.84375,11.6875,0.6551724137931034,4.379310344827586,-13,0.18857758620689657,7.308189655172414,19,1
2022,137,1181,78,1168,61,2,15,0.8235294117647058,13.029411764705882,0.6551724137931034,2.896551724137931,-13,0.16835699797160242,10.132860040567952,17,1
2022,137,1222,82,1412,68,5,12,0.8529411764705882,16.941176470588236,0.78125,11.8125,-7,0.0716911764705882,5.1286764705882355,14,1
2022,137,1228,54,1151,53,4,13,0.7096774193548387,8.129032258064516,0.78125,7.3125,-9,-0.07157258064516125,0.816532258064516,1,1
2022,137,1235,59,1261,54,11,6,0.625,3.46875,0.6666666666666666,9.575757575757576,5,-0.04166666666666663,-6.107007575757576,5,1
2022,137,1274,68,1425,66,10,7,0.696969696969697,3.787878787878789,0.7878787878787878,6.666666666666667,3,-0.09090909090909083,-2.878787878787878,2,1
2022,137,1277,74,1172,73,7,10,0.6470588235294118,3.6470588235294117,0.8125,8.8125,-3,-0.1654411764705882,-5.165441176470589,1,1
2022,137,1323,78,1104,64,11,6,0.6774193548387096,5.0,0.59375,3.5625,5,0.08366935483870963,1.4375,14,1
2022,137,1326,54,1260,41,7,10,0.6333333333333333,5.333333333333333,0.7741935483870968,11.225806451612904,-3,-0.14086021505376345,-5.892473118279571,13,1
2022,137,1345,78,1463,56,3,14,0.7941176470588235,11.029411764705882,0.6206896551724138,2.0344827586206895,-11,0.17342799188640967,8.994929006085194,22,1
2022,137,1395,69,1371,42,9,8,0.625,3.09375,0.6666666666666666,5.266666666666667,1,-0.04166666666666663,-2.1729166666666666,27,1
2022,137,1400,81,1439,73,6,11,0.65625,8.71875,0.6571428571428571,8.457142857142857,-5,-0.0008928571428571397,0.2616071428571427,8,1
2022,137,1403,97,1286,62,3,14,0.7352941176470589,11.382352941176471,0.78125,6.531249999999999,-11,-0.045955882352941124,4.851102941176472,35,1
2022,137,1437,80,1174,60,2,15,0.7878787878787878,9.545454545454545,0.6363636363636364,2.8181818181818183,-13,0.1515151515151515,6.727272727272727,20,1
2022,137,1458,67,1159,60,3,14,0.7741935483870968,4.161290322580645,0.6666666666666666,7.787878787878788,-11,0.10752688172043012,-3.626588465298143,7,1
2022,138,1116,53,1308,48,4,12,0.7575757575757576,8.393939393939394,0.7931034482758621,6.206896551724138,-8,-0.03552769070010453,2.1870428422152566,5,1
2022,138,1211,82,1272,78,1,9,0.896551724137931,22.482758620689655,0.6774193548387096,7.032258064516129,-8,0.21913236929922142,15.450500556173527,4,1
2022,138,1242,79,1166,72,1,9,0.8235294117647058,10.441176470588236,0.6666666666666666,3.090909090909091,-8,0.1568627450980392,7.350267379679145,7,1
2022,138,1276,76,1397,68,11,3,0.5483870967741935,3.161290322580645,0.7878787878787878,10.424242424242424,8,-0.23949169110459434,-7.262952101661779,8,1
2022,138,1314,93,1124,86,8,1,0.7272727272727273,5.787878787878788,0.8125,12.875,7,-0.08522727272727271,-7.087121212121212,7,1
2022,138,1344,79,1350,51,4,12,0.8333333333333334,4.799999999999999,0.6571428571428571,3.4285714285714284,-8,0.17619047619047623,1.3714285714285706,28,1
2022,138,1389,70,1293,60,15,7,0.6206896551724138,3.9310344827586206,0.9310344827586207,14.0,8,-0.31034482758620685,-10.068965517241379,10,1
2022,138,1417,72,1388,56,4,5,0.78125,11.5625,0.7741935483870968,8.35483870967742,-1,0.007056451612903247,3.20766129032258,16,1
2022,139,1112,85,1395,80,1,9,0.9117647058823529,17.029411764705884,0.625,3.09375,-8,0.2867647058823529,13.935661764705884,5,1
2022,139,1181,85,1277,76,2,7,0.8235294117647058,13.029411764705882,0.6470588235294118,3.6470588235294117,-5,0.17647058823529405,9.382352941176471,9,1
2022,139,1222,68,1228,53,5,4,0.8529411764705882,16.941176470588236,0.7096774193548387,8.129032258064516,1,0.14326375711574946,8.81214421252372,15,1
2022,139,1235,54,1458,49,11,3,0.625,3.46875,0.7741935483870968,4.161290322580645,8,-0.14919354838709675,-0.692540322580645,5,1
2022,139,1274,79,1120,61,10,2,0.696969696969697,3.787878787878789,0.84375,11.6875,8,-0.14678030303030298,-7.899621212121211,18,1
2022,139,1345,81,1400,71,3,6,0.7941176470588235,11.029411764705882,0.65625,8.71875,-3,0.13786764705882348,2.3106617647058822,10,1
2022,139,1403,59,1323,53,3,11,0.7352941176470589,11.382352941176471,0.6774193548387096,5.0,-8,0.057874762808349245,6.382352941176471,6,1
2022,139,1437,71,1326,61,2,7,0.7878787878787878,9.545454545454545,0.6333333333333333,5.333333333333333,-5,0.15454545454545454,4.212121212121212,10,1
2022,143,1116,74,1211,68,4,1,0.7575757575757576,8.393939393939394,0.896551724137931,22.482758620689655,3,-0.13897596656217348,-14.08881922675026,6,1
2022,143,1181,78,1403,73,2,3,0.8235294117647058,13.029411764705882,0.7352941176470589,11.382352941176471,-1,0.08823529411764697,1.6470588235294112,5,1
2022,143,1222,72,1112,60,5,1,0.8529411764705882,16.941176470588236,0.9117647058823529,17.029411764705884,4,-0.05882352941176472,-0.08823529411764852,12,1
2022,143,1437,63,1276,55,2,11,0.7878787878787878,9.545454545454545,0.5483870967741935,3.161290322580645,-9,0.23949169110459434,6.3841642228739,8,1
2022,144,1242,66,1344,61,1,4,0.8235294117647058,10.441176470588236,0.8333333333333334,4.799999999999999,-3,-0.009803921568627527,5.641176470588237,5,1
2022,144,1274,70,1235,56,10,11,0.696969696969697,3.787878787878789,0.625,3.46875,-1,0.07196969696969702,0.31912878787878896,14,1
2022,144,1314,73,1417,66,8,4,0.7272727272727273,5.787878787878788,0.78125,11.5625,4,-0.05397727272727271,-5.774621212121212,7,1
2022,144,1389,67,1345,64,15,3,0.6206896551724138,3.9310344827586206,0.7941176470588235,11.029411764705882,12,-0.17342799188640967,-7.098377281947261,3,1
2022,145,1181,78,1116,69,2,4,0.8235294117647058,13.029411764705882,0.7575757575757576,8.393939393939394,-2,0.06595365418894827,4.635472370766488,9,1
2022,145,1437,50,1222,44,2,5,0.7878787878787878,9.545454545454545,0.8529411764705882,16.941176470588236,-3,-0.06506238859180036,-7.3957219251336905,6,1
2022,146,1242,76,1274,50,1,10,0.8235294117647058,10.441176470588236,0.696969696969697,3.787878787878789,-9,0.12655971479500883,6.6532976827094465,26,1
2022,146,1314,69,1389,49,8,15,0.7272727272727273,5.787878787878788,0.6206896551724138,3.9310344827586206,-7,0.10658307210031348,1.8568443051201675,20,1
2022,152,1242,81,1437,65,1,2,0.8235294117647058,10.441176470588236,0.7878787878787878,9.545454545454545,-1,0.035650623885918,0.8957219251336905,16,1
2022,152,1314,81,1181,77,8,2,0.7272727272727273,5.787878787878788,0.8235294117647058,13.029411764705882,6,-0.09625668449197855,-7.241532976827094,4,1
2022,154,1242,72,1314,69,1,8,0.8235294117647058,10.441176470588236,0.7272727272727273,5.787878787878788,-7,0.09625668449197855,4.653297682709447,3,1
2016,137,3196,59,3107,61,5,12,0.7333333333333333,8.7,0.8709677419354839,18.677419354838708,-7,-0.1376344086021506,-9.977419354838709,-2,0
2016,137,3308,52,3113,74,15,2,0.8571428571428571,8.964285714285714,0.8064516129032258,9.258064516129032,13,0.05069124423963134,-0.2937788018433185,-22,0
2016,137,3385,57,3120,68,8,9,0.71875,6.8125,0.6129032258064516,3.032258064516129,-1,0.10584677419354838,3.780241935483871,-11,0
2016,137,3225,59,3124,89,16,1,0.7096774193548387,10.61290322580645,0.9705882352941176,24.61764705882353,15,-0.2609108159392789,-14.004743833017079,-30,0
2016,137,3241,67,3177,97,11,6,0.84375,15.40625,0.7575757575757576,16.272727272727273,5,0.08617424242424243,-0.8664772727272734,-30,0
2016,137,3203,51,3243,56,8,9,0.8125,9.65625,0.6,3.933333333333333,-1,0.21250000000000002,5.722916666666666,-5,0
2016,137,3146,60,3257,87,14,3,0.8888888888888888,9.11111111111111,0.78125,12.718749999999998,11,0.10763888888888884,-3.6076388888888875,-27,0
2016,137,3125,60,3277,74,13,4,0.7333333333333333,10.26666666666667,0.75,11.8125,9,-0.01666666666666672,-1.5458333333333307,-14,0
2016,137,3151,50,3280,60,12,5,0.7741935483870968,5.32258064516129,0.7878787878787878,15.93939393939394,7,-0.013685239491691092,-10.61681329423265,-10,0
2016,137,3138,69,3326,88,14,3,0.6060606060606061,1.0606060606060606,0.7741935483870968,12.258064516129032,11,-0.16813294232649068,-11.197458455522971,-19,0
2016,137,3407,31,3333,73,15,2,0.6,3.033333333333333,0.875,15.5,13,-0.275,-12.466666666666667,-42,0
2016,137,3239,41,3376,77,16,1,0.6666666666666666,10.0,0.96875,17.90625,15,-0.30208333333333337,-7.90625,-36,0
2016,137,3329,54,3382,65,7,10,0.7,7.6,0.7666666666666667,7.966666666666667,-3,-0.06666666666666676,-0.36666666666666714,-11,0
2016,137,3119,56,3393,73,13,4,0.9333333333333333,20.066666666666666,0.78125,13.0,9,0.15208333333333335,7.066666666666666,-17,0
2016,137,3453,53,3397,59,10,7,0.875,14.625,0.59375,7.0625,3,0.28125,7.5625,-6,0
2016,137,3343,65,3452,74,11,6,0.8214285714285714,18.25,0.7272727272727273,12.545454545454545,5,0.0941558441558441,5.704545454545455,-9,0
2016,138,3352,49,3163,101,16,1,0.6129032258064516,3.806451612903226,1.0,39.6875,15,-0.3870967741935484,-35.881048387096776,-52,0
2016,138,3371,76,3182,97,8,9,0.7419354838709677,7.354838709677419,0.8387096774193549,10.548387096774194,-1,-0.09677419354838712,-3.193548387096775,-21,0
2016,138,3292,55,3199,72,12,5,0.75,8.8125,0.7666666666666667,17.066666666666666,7,-0.01666666666666672,-8.254166666666666,-17,0
2016,138,3208,58,3231,62,8,9,0.7,10.266666666666667,0.6451612903225806,4.225806451612903,-1,0.05483870967741933,6.0408602150537645,-4,0
2016,138,3421,31,3246,85,14,3,0.8,8.833333333333334,0.7666666666666667,13.433333333333332,11,0.033333333333333326,-4.599999999999998,-54,0
2016,138,3233,58,3268,74,15,2,0.6764705882352942,5.970588235294118,0.9090909090909091,24.03030303030303,13,-0.2326203208556149,-18.059714795008915,-16,0
2016,138,3140,69,3281,78,7,10,0.8064516129032258,6.903225806451613,0.7,10.5,-3,0.1064516129032258,-3.596774193548387,-9,0
2016,138,3299,61,3323,95,16,1,0.6071428571428571,4.107142857142857,0.96875,19.125,15,-0.3616071428571429,-15.017857142857142,-34,0
2016,138,3345,45,3328,61,11,6,0.6451612903225806,6.516129032258065,0.6774193548387096,8.32258064516129,5,-0.032258064516129004,-1.806451612903225,-16,0
2016,138,3274,71,3355,74,5,12,0.75,10.4375,0.8125,10.8125,-7,-0.0625,-0.375,-3,0
2016,138,3161,45,3378,48,11,6,0.9666666666666667,15.666666666666668,0.71875,11.40625,5,0.24791666666666667,4.260416666666668,-3,0
2016,138,3362,58,3390,85,13,4,0.6333333333333333,3.0000000000000004,0.7741935483870968,13.67741935483871,9,-0.14086021505376345,-10.67741935483871,-27,0
2016,138,3106,42,3400,86,15,2,0.6206896551724138,4.0,0.875,15.0,13,-0.2543103448275862,-11.0,-44,0
2016,138,3283,65,3401,74,13,4,0.71875,7.375,0.7,9.8,9,0.018750000000000044,-2.4250000000000007,-9,0
2016,138,3218,50,3417,66,14,3,0.6774193548387096,5.935483870967742,0.75,10.34375,11,-0.07258064516129037,-4.408266129032258,-16,0
2016,138,3335,53,3449,65,10,7,0.8518518518518519,10.518518518518519,0.6875,8.78125,3,0.16435185185185186,1.737268518518519,-12,0
2016,139,3120,52,3124,84,9,1,0.6129032258064516,3.032258064516129,0.9705882352941176,24.61764705882353,8,-0.357685009487666,-21.5853889943074,-32,0
2016,139,3257,72,3177,73,3,6,0.78125,12.718749999999998,0.7575757575757576,16.272727272727273,-3,0.02367424242424243,-3.553977272727275,-1,0
2016,139,3277,72,3280,74,4,5,0.75,11.8125,0.7878787878787878,15.93939393939394,-1,-0.037878787878787845,-4.1268939393939394,-2,0
2016,139,3452,81,3326,88,6,3,0.7272727272727273,12.545454545454545,0.7741935483870968,12.258064516129032,3,-0.04692082111436946,0.28739002932551294,-7,0
2016,139,3382,40,3333,69,10,2,0.7666666666666667,7.966666666666667,0.875,15.5,8,-0.10833333333333328,-7.533333333333333,-29,0
2016,139,3243,47,3376,73,9,1,0.6,3.933333333333333,0.96875,17.90625,8,-0.36875,-13.972916666666666,-26,0
2016,139,3107,59,3393,76,12,4,0.8709677419354839,18.677419354838708,0.78125,13.0,8,0.08971774193548387,5.677419354838708,-17,0
2016,139,3113,64,3397,75,2,7,0.8064516129032258,9.258064516129032,0.59375,7.0625,-5,0.21270161290322576,2.195564516129032,-11,0
2016,140,3182,51,3163,97,9,1,0.8387096774193549,10.548387096774194,1.0,39.6875,8,-0.16129032258064513,-29.139112903225808,-46,0
2016,140,3401,56,3199,74,4,5,0.7,9.8,0.7666666666666667,17.066666666666666,-1,-0.06666666666666676,-7.266666666666666,-18,0
2016,140,3328,58,3246,79,6,3,0.6774193548387096,8.32258064516129,0.7666666666666667,13.433333333333332,3,-0.08924731182795709,-5.110752688172042,-21,0
2016,140,3231,70,3323,87,9,1,0.6451612903225806,4.225806451612903,0.96875,19.125,8,-0.3235887096774194,-14.899193548387096,-17,0
2016,140,3355,65,3390,66,12,4,0.8125,10.8125,0.7741935483870968,13.67741935483871,8,0.03830645161290325,-2.86491935483871,-1,0
2016,140,3281,55,3400,73,10,2,0.7,10.5,0.875,15.0,8,-0.17500000000000004,-4.5,-18,0
2016,140,3378,67,3417,72,6,3,0.71875,11.40625,0.75,10.34375,3,-0.03125,1.0625,-5,0
2016,140,3268,65,3449,74,2,7,0.9090909090909091,24.03030303030303,0.6875,8.78125,-5,0.22159090909090906,15.249053030303031,-9,0
2016,144,3323,84,3390,90,1,4,0.96875,19.125,0.7741935483870968,13.67741935483871,-3,0.19455645161290325,5.44758064516129,-6,0
2016,144,3376,72,3393,80,1,4,0.96875,17.90625,0.78125,13.0,-3,0.1875,4.90625,-8,0
2016,144,3326,62,3397,78,3,7,0.7741935483870968,12.258064516129032,0.59375,7.0625,-4,0.18044354838709675,5.195564516129032,-16,0
2016,144,3246,72,3449,85,3,7,0.7666666666666667,13.433333333333332,0.6875,8.78125,-4,0.07916666666666672,4.652083333333332,-13,0
2016,145,3199,58,3124,78,5,1,0.7666666666666667,17.066666666666666,0.9705882352941176,24.61764705882353,4,-0.20392156862745092,-7.550980392156863,-20,0
2016,145,3280,38,3163,98,5,1,0.7878787878787878,15.93939393939394,1.0,39.6875,4,-0.21212121212121215,-23.748106060606062,-60,0
2016,145,3177,71,3333,83,6,2,0.7575757575757576,16.272727272727273,0.875,15.5,4,-0.11742424242424243,0.7727272727272734,-12,0
2016,145,3417,64,3400,72,3,2,0.75,10.34375,0.875,15.0,1,-0.125,-4.65625,-8,0
2016,146,3397,67,3393,89,7,4,0.59375,7.0625,0.78125,13.0,3,-0.1875,-5.9375,-22,0
2016,146,3390,76,3449,85,4,7,0.7741935483870968,13.67741935483871,0.6875,8.78125,-3,0.08669354838709675,4.89616935483871,-9,0
2016,147,3400,65,3163,86,2,1,0.875,15.0,1.0,39.6875,1,-0.125,-24.6875,-21,0
2016,147,3124,57,3333,60,1,2,0.9705882352941176,24.61764705882353,0.875,15.5,-1,0.09558823529411764,9.117647058823529,-3,0
2016,153,3333,51,3163,80,2,1,0.875,15.5,1.0,39.6875,1,-0.125,-24.1875,-29,0
2016,153,3449,59,3393,80,7,4,0.6875,8.78125,0.78125,13.0,3,-0.09375,-4.21875,-21,0
2016,155,3393,51,3163,82,4,1,0.78125,13.0,1.0,39.6875,3,-0.21875,-26.6875,-31,0
2017,137,3277,61,3113,73,9,8,0.65625,7.03125,0.6129032258064516,6.161290322580645,1,0.043346774193548376,0.869959677419355,-12,0
2017,137,3405,49,3166,76,10,7,0.75,8.28125,0.7666666666666667,8.066666666666666,3,-0.01666666666666672,0.21458333333333357,-27,0
2017,137,3320,67,3177,88,10,7,0.7419354838709677,9.387096774193548,0.7878787878787878,13.727272727272727,3,-0.045943304007820096,-4.340175953079179,-21,0
2017,137,3442,66,3199,87,14,3,0.8,9.8,0.8064516129032258,21.806451612903224,11,-0.006451612903225712,-12.006451612903223,-21,0
2017,137,3125,70,3246,73,13,4,0.8387096774193549,12.096774193548388,0.6774193548387096,8.193548387096774,9,0.16129032258064524,3.903225806451614,-3,0
2017,137,3137,61,3268,103,14,3,0.84375,9.9375,0.9375,25.4375,11,-0.09375,-15.5,-42,0
2017,137,3407,69,3280,110,15,2,0.6666666666666666,8.266666666666667,0.8787878787878788,19.454545454545453,13,-0.21212121212121215,-11.187878787878786,-41,0
2017,137,3378,64,3281,66,11,6,0.75,9.3125,0.6774193548387096,4.645161290322581,5,0.07258064516129037,4.667338709677419,-2,0
2017,137,3120,48,3301,62,11,6,0.5483870967741935,2.225806451612903,0.7333333333333333,12.466666666666665,5,-0.18494623655913978,-10.240860215053761,-14,0
2017,137,3352,49,3323,79,16,1,0.6774193548387096,6.645161290322581,0.9090909090909091,18.21212121212121,15,-0.23167155425219943,-11.566959921798631,-30,0
2017,137,3443,63,3326,70,12,5,0.8181818181818182,13.757575757575756,0.8125,15.5625,7,0.005681818181818232,-1.804924242424244,-7,0
2017,137,3253,55,3333,56,15,2,0.6875,2.46875,0.8787878787878788,12.272727272727273,13,-0.19128787878787878,-9.803977272727273,-1,0
2017,137,3453,62,3345,74,8,9,0.84375,18.65625,0.6470588235294118,7.823529411764706,-1,0.1966911764705882,10.832720588235293,-12,0
2017,137,3421,40,3376,90,16,1,0.5625,2.3125,0.8709677419354839,19.258064516129032,15,-0.3084677419354839,-16.945564516129032,-50,0
2017,137,3146,50,3400,78,14,3,0.8461538461538461,11.73076923076923,0.7419354838709677,12.35483870967742,11,0.1042183622828784,-0.62406947890819,-28,0
2017,137,3189,62,3452,75,11,6,0.8125,11.21875,0.696969696969697,12.545454545454545,5,0.11553030303030298,-1.326704545454545,-13,0
2017,138,3411,30,3124,119,16,1,0.7096774193548387,4.645161290322581,0.9090909090909091,32.57575757575758,15,-0.19941348973607032,-27.930596285434998,-89,0
2017,138,3261,52,3143,55,8,9,0.6451612903225806,4.709677419354839,0.59375,5.03125,-1,0.05141129032258063,-0.32157258064516103,-3,0
2017,138,3107,55,3163,116,16,1,0.6451612903225806,3.6451612903225805,1.0,32.8125,15,-0.3548387096774194,-29.16733870967742,-61,0
2017,138,3214,31,3181,94,15,2,0.625,2.15625,0.84375,17.71875,13,-0.21875,-15.5625,-63,0
2017,138,3179,54,3243,67,10,7,0.8709677419354839,16.93548387096774,0.6875,5.59375,3,0.18346774193548387,11.34173387096774,-13,0
2017,138,3151,62,3257,82,13,4,0.6774193548387096,5.645161290322581,0.7941176470588235,14.882352941176471,9,-0.11669829222011385,-9.237191650853891,-20,0
2017,138,3195,60,3274,62,13,4,0.75,14.4375,0.7419354838709677,9.645161290322578,9,0.008064516129032251,4.792338709677422,-2,0
2017,138,3211,62,3328,75,11,6,0.8125,14.5,0.7096774193548387,5.096774193548387,5,0.10282258064516125,9.403225806451612,-13,0
2017,138,3396,70,3332,71,7,10,0.7741935483870968,9.580645161290322,0.6060606060606061,6.151515151515151,-3,0.16813294232649068,3.4291300097751707,-1,0
2017,138,3266,65,3346,68,5,12,0.78125,9.0,0.8181818181818182,11.575757575757578,-7,-0.03693181818181823,-2.575757575757578,-3,0
2017,138,3308,64,3390,72,15,2,0.7857142857142857,7.928571428571429,0.8484848484848485,16.575757575757574,13,-0.06277056277056281,-8.647186147186146,-8,0
2017,138,3235,65,3393,85,9,8,0.6,5.833333333333333,0.6774193548387096,12.35483870967742,1,-0.07741935483870965,-6.521505376344087,-20,0
2017,138,3173,57,3397,66,12,5,0.7096774193548387,6.580645161290323,0.6333333333333333,8.0,7,0.07634408602150544,-1.419354838709677,-9,0
2017,138,3335,61,3401,63,12,5,0.75,8.285714285714286,0.65625,6.90625,7,0.09375,1.3794642857142865,-2,0
2017,138,3129,56,3417,83,13,4,0.7666666666666667,5.266666666666667,0.7419354838709677,9.935483870967742,9,0.02473118279569897,-4.668817204301075,-27,0
2017,138,3286,63,3449,91,14,3,0.7931034482758621,7.068965517241379,0.84375,21.625,11,-0.0506465517241379,-14.556034482758621,-28,0
2017,139,3281,55,3199,77,6,3,0.6774193548387096,4.645161290322581,0.8064516129032258,21.806451612903224,3,-0.12903225806451613,-17.161290322580644,-22,0
2017,139,3452,56,3268,83,6,3,0.696969696969697,12.545454545454545,0.9375,25.4375,3,-0.24053030303030298,-12.892045454545455,-27,0
2017,139,3177,71,3280,92,7,2,0.7878787878787878,13.727272727272727,0.8787878787878788,19.454545454545453,5,-0.09090909090909094,-5.727272727272727,-21,0
2017,139,3345,82,3323,88,9,1,0.6470588235294118,7.823529411764706,0.9090909090909091,18.21212121212121,8,-0.26203208556149726,-10.388591800356505,-6,0
2017,139,3246,68,3326,82,4,5,0.6774193548387096,8.193548387096774,0.8125,15.5625,-1,-0.13508064516129037,-7.368951612903226,-14,0
2017,139,3166,52,3333,64,7,2,0.7666666666666667,8.066666666666666,0.8787878787878788,12.272727272727273,5,-0.11212121212121207,-4.206060606060607,-12,0
2017,139,3113,68,3376,71,8,1,0.6129032258064516,6.161290322580645,0.8709677419354839,19.258064516129032,7,-0.25806451612903225,-13.096774193548388,-3,0
2017,139,3301,80,3400,84,6,3,0.7333333333333333,12.466666666666665,0.7419354838709677,12.35483870967742,3,-0.008602150537634468,0.11182795698924508,-4,0
2017,140,3143,46,3124,86,9,1,0.59375,5.03125,0.9090909090909091,32.57575757575758,8,-0.31534090909090906,-27.544507575757578,-40,0
2017,140,3393,64,3163,94,8,1,0.6774193548387096,12.35483870967742,1.0,32.8125,7,-0.32258064516129037,-20.45766129032258,-30,0
2017,140,3397,64,3257,75,5,4,0.6333333333333333,8.0,0.7941176470588235,14.882352941176471,1,-0.16078431372549018,-6.882352941176471,-11,0
2017,140,3181,65,3332,74,2,10,0.84375,17.71875,0.6060606060606061,6.151515151515151,-8,0.23768939393939392,11.567234848484848,-9,0
2017,140,3274,78,3346,85,4,12,0.7419354838709677,9.645161290322578,0.8181818181818182,11.575757575757578,-8,-0.07624633431085048,-1.9305962854349996,-7,0
2017,140,3243,48,3390,69,7,2,0.6875,5.59375,0.8484848484848485,16.575757575757574,5,-0.1609848484848485,-10.982007575757574,-21,0
2017,140,3401,43,3417,75,5,4,0.65625,6.90625,0.7419354838709677,9.935483870967742,1,-0.08568548387096775,-3.029233870967742,-32,0
2017,140,3328,82,3449,108,6,3,0.7096774193548387,5.096774193548387,0.84375,21.625,3,-0.13407258064516125,-16.528225806451612,-26,0
2017,144,3257,63,3124,97,4,1,0.7941176470588235,14.882352941176471,0.9090909090909091,32.57575757575758,3,-0.11497326203208558,-17.693404634581107,-34,0
2017,144,3449,64,3280,75,3,2,0.84375,21.625,0.8787878787878788,19.454545454545453,1,-0.035037878787878785,2.1704545454545467,-11,0
2017,144,3326,76,3323,99,5,1,0.8125,15.5625,0.9090909090909091,18.21212121212121,4,-0.09659090909090906,-2.649621212121211,-23,0
2017,144,3400,66,3390,77,3,2,0.7419354838709677,12.35483870967742,0.8484848484848485,16.575757575757574,1,-0.10654936461388076,-4.220918866080154,-11,0
2017,145,3417,71,3163,86,4,1,0.7419354838709677,9.935483870967742,1.0,32.8125,3,-0.25806451612903225,-22.877016129032256,-15,0
2017,145,3333,53,3199,66,2,3,0.8787878787878788,12.272727272727273,0.8064516129032258,21.806451612903224,-1,0.07233626588465303,-9.53372434017595,-13,0
2017,145,3268,63,3332,77,3,10,0.9375,25.4375,0.6060606060606061,6.151515151515151,-7,0.3314393939393939,19.285984848484848,-14,0
2017,145,3346,58,3376,100,12,1,0.8181818181818182,11.575757575757578,0.8709677419354839,19.258064516129032,11,-0.05278592375366564,-7.682306940371454,-42,0
2017,146,3124,85,3280,94,1,2,0.9090909090909091,32.57575757575758,0.8787878787878788,19.454545454545453,-1,0.030303030303030276,13.121212121212125,-9,0
2017,146,3323,75,3390,76,1,2,0.9090909090909091,18.21212121212121,0.8484848484848485,16.575757575757574,-1,0.06060606060606055,1.6363636363636367,-1,0
2017,147,3332,52,3163,90,10,1,0.6060606060606061,6.151515151515151,1.0,32.8125,9,-0.3939393939393939,-26.660984848484848,-38,0
2017,147,3199,64,3376,71,3,1,0.8064516129032258,21.806451612903224,0.8709677419354839,19.258064516129032,2,-0.06451612903225812,2.548387096774192,-7,0
2017,151,3163,64,3280,66,1,2,1.0,32.8125,0.8787878787878788,19.454545454545453,-1,0.12121212121212122,13.357954545454547,-2,0
2017,151,3390,53,3376,62,2,1,0.8484848484848485,16.575757575757574,0.8709677419354839,19.258064516129032,1,-0.022482893450635366,-2.6823069403714577,-9,0
2017,153,3280,55,3376,67,2,1,0.8787878787878788,19.454545454545453,0.8709677419354839,19.258064516129032,1,0.00782013685239491,0.19648093841642122,-12,0
2018,137,3212,46,3124,96,15,2,0.59375,-0.09375,0.96875,30.687500000000004,13,-0.375,-30.781250000000004,-50,0
2018,137,3328,79,3177,90,12,5,0.5333333333333333,3.8,0.7878787878787878,12.545454545454545,7,-0.2545454545454545,-8.745454545454546,-11,0
2018,137,3129,42,3257,74,16,1,0.7,5.8,0.9411764705882353,19.647058823529413,15,-0.24117647058823533,-13.847058823529412,-32,0
2018,137,3173,65,3266,84,9,8,0.7931034482758621,12.241379310344827,0.71875,10.0,1,0.0743534482758621,2.2413793103448274,-19,0
2018,137,3343,57,3268,77,12,5,0.8275862068965517,13.655172413793103,0.78125,16.28125,7,0.04633620689655171,-2.626077586206897,-20,0
2018,137,3294,61,3276,75,10,7,0.8125,6.96875,0.7096774193548387,13.483870967741936,3,0.10282258064516125,-6.515120967741936,-14,0
2018,137,3453,77,3278,89,7,10,0.90625,19.125,0.7419354838709677,11.290322580645162,-3,0.16431451612903225,7.834677419354838,-12,0
2018,137,3189,35,3301,62,13,4,0.7741935483870968,13.870967741935484,0.75,9.59375,9,0.024193548387096753,4.277217741935484,-27,0
2018,137,3169,81,3323,99,16,1,0.5454545454545454,0.8181818181818182,0.90625,18.5625,15,-0.3607954545454546,-17.744318181818183,-18,0
2018,137,3370,45,3332,88,15,2,0.5625,0.96875,0.8823529411764706,18.823529411764707,13,-0.31985294117647056,-17.854779411764707,-43,0
2018,137,3443,58,3333,82,11,6,0.7419354838709677,12.612903225806452,0.7666666666666667,15.5,5,-0.02473118279569897,-2.887096774193548,-24,0
2018,137,3299,52,3376,63,15,2,0.7241379310344828,5.931034482758621,0.8125,15.53125,13,-0.08836206896551724,-9.600215517241379,-11,0
2018,137,3251,60,3397,100,14,3,0.7096774193548387,8.935483870967744,0.7741935483870968,13.064516129032258,11,-0.06451612903225801,-4.129032258064514,-40,0
2018,137,3179,76,3401,89,13,4,0.78125,13.9375,0.7272727272727273,9.757575757575758,9,0.05397727272727271,4.179924242424242,-13,0
2018,137,3355,74,3437,81,8,9,0.8064516129032258,16.838709677419356,0.7333333333333333,7.566666666666666,-1,0.07311827956989247,9.27204301075269,-7,0
2018,137,3143,62,3438,68,7,10,0.6774193548387096,3.3870967741935485,0.5806451612903226,1.096774193548387,-3,0.09677419354838701,2.2903225806451615,-6,0
2018,138,3304,62,3113,73,10,7,0.6774193548387096,5.67741935483871,0.6363636363636364,10.909090909090908,3,0.04105571847507328,-5.231671554252198,-11,0
2018,138,3378,79,3138,102,6,11,0.7878787878787878,13.303030303030303,0.84375,13.3125,-5,-0.055871212121212155,-0.009469696969697239,-23,0
2018,138,3261,69,3141,78,6,11,0.6785714285714286,5.178571428571429,0.8709677419354839,11.064516129032258,-5,-0.19239631336405527,-5.885944700460829,-9,0
2018,138,3384,52,3163,140,16,1,0.71875,8.96875,1.0,36.90625,15,-0.28125,-27.9375,-88,0
2018,138,3234,70,3166,76,6,11,0.7741935483870968,10.32258064516129,0.6,2.933333333333333,-5,0.17419354838709677,7.3892473118279565,-6,0
2018,138,3125,58,3181,72,12,5,0.9090909090909091,17.666666666666668,0.7333333333333333,12.833333333333334,7,0.17575757575757578,4.833333333333334,-14,0
2018,138,3281,70,3195,80,5,12,0.7741935483870968,9.35483870967742,0.8709677419354839,17.29032258064516,-7,-0.09677419354838712,-7.93548387096774,-10,0
2018,138,3114,49,3199,91,14,3,0.71875,7.375,0.8064516129032258,17.096774193548388,11,-0.08770161290322576,-9.721774193548388,-42,0
2018,138,3273,63,3208,68,13,4,0.9375,16.4375,0.8064516129032258,10.64516129032258,9,0.13104838709677424,5.79233870967742,-5,0
2018,138,3311,50,3280,95,16,1,0.5517241379310345,-0.10344827586206896,0.9696969696969697,26.303030303030305,15,-0.41797283176593525,-26.406478578892372,-45,0
2018,138,3203,45,3326,87,14,3,0.59375,2.5625,0.8181818181818182,13.969696969696969,11,-0.22443181818181823,-11.407196969696969,-42,0
2018,138,3393,57,3329,84,8,9,0.7333333333333333,7.633333333333334,0.6666666666666666,11.033333333333333,-1,0.06666666666666665,-3.3999999999999995,-27,0
2018,138,3274,72,3346,86,8,9,0.6774193548387096,7.645161290322581,0.84375,14.03125,-1,-0.16633064516129037,-6.386088709677419,-14,0
2018,138,3211,68,3390,82,13,4,0.84375,13.65625,0.6875,6.4375,9,0.15625,7.21875,-14,0
2018,138,3263,54,3400,83,15,2,0.7,7.4,0.8125,16.96875,13,-0.11250000000000004,-9.56875,-29,0
2018,138,3110,60,3417,71,14,3,0.8125,6.9375,0.7741935483870968,12.64516129032258,11,0.03830645161290325,-5.70766129032258,-11,0
2018,139,3276,58,3124,80,7,2,0.7096774193548387,13.483870967741936,0.96875,30.687500000000004,5,-0.25907258064516125,-17.203629032258068,-22,0
2018,139,3266,72,3257,90,8,1,0.71875,10.0,0.9411764705882353,19.647058823529413,7,-0.22242647058823528,-9.647058823529413,-18,0
2018,139,3268,60,3301,74,5,4,0.78125,16.28125,0.75,9.59375,1,0.03125,6.6875,-14,0
2018,139,3437,72,3323,98,9,1,0.7333333333333333,7.566666666666666,0.90625,18.5625,8,-0.17291666666666672,-10.995833333333334,-26,0
2018,139,3278,73,3332,101,10,2,0.7419354838709677,11.290322580645162,0.8823529411764706,18.823529411764707,8,-0.1404174573055028,-7.533206831119545,-28,0
2018,139,3397,59,3333,66,3,6,0.7741935483870968,13.064516129032258,0.7666666666666667,15.5,-3,0.007526881720430034,-2.435483870967742,-7,0
2018,139,3438,56,3376,66,10,2,0.5806451612903226,1.096774193548387,0.8125,15.53125,8,-0.23185483870967738,-14.434475806451612,-10,0
2018,139,3177,79,3401,80,5,4,0.7878787878787878,12.545454545454545,0.7272727272727273,9.757575757575758,1,0.06060606060606055,2.787878787878787,-1,0
2018,140,3199,65,3138,86,3,11,0.8064516129032258,17.096774193548388,0.84375,13.3125,-8,-0.037298387096774244,3.784274193548388,-21,0
2018,140,3326,78,3141,95,3,11,0.8181818181818182,13.969696969696969,0.8709677419354839,11.064516129032258,-8,-0.05278592375366564,2.905180840664711,-17,0
2018,140,3346,46,3163,71,9,1,0.84375,14.03125,1.0,36.90625,8,-0.15625,-22.875,-25,0
2018,140,3208,40,3181,66,4,5,0.8064516129032258,10.64516129032258,0.7333333333333333,12.833333333333334,-1,0.07311827956989247,-2.188172043010754,-26,0
2018,140,3329,56,3280,71,9,1,0.6666666666666666,11.033333333333333,0.9696969696969697,26.303030303030305,8,-0.3030303030303031,-15.269696969696971,-15,0
2018,140,3195,70,3390,90,12,4,0.8709677419354839,17.29032258064516,0.6875,6.4375,8,0.18346774193548387,10.85282258064516,-20,0
2018,140,3113,65,3400,85,7,2,0.6363636363636364,10.909090909090908,0.8125,16.96875,5,-0.17613636363636365,-6.059659090909092,-20,0
2018,140,3166,64,3417,86,11,3,0.6,2.933333333333333,0.7741935483870968,12.64516129032258,8,-0.17419354838709677,-9.711827956989247,-22,0
2018,144,3390,59,3257,86,4,1,0.6875,6.4375,0.9411764705882353,19.647058823529413,3,-0.2536764705882353,-13.209558823529413,-27,0
2018,144,3301,57,3280,71,4,1,0.75,9.59375,0.9696969696969697,26.303030303030305,3,-0.21969696969696972,-16.709280303030305,-14,0
2018,144,3124,67,3333,72,2,6,0.96875,30.687500000000004,0.7666666666666667,15.5,-4,0.20208333333333328,15.187500000000004,-5,0
2018,144,3400,75,3417,84,2,3,0.8125,16.96875,0.7741935483870968,12.64516129032258,-1,0.03830645161290325,4.32358870967742,-9,0
2018,145,3181,59,3163,72,5,1,0.7333333333333333,12.833333333333334,1.0,36.90625,4,-0.2666666666666667,-24.072916666666664,-13,0
2018,145,3401,84,3323,90,4,1,0.7272727272727273,9.757575757575758,0.90625,18.5625,3,-0.1789772727272727,-8.804924242424242,-6,0
2018,145,3141,69,3332,83,11,2,0.8709677419354839,11.064516129032258,0.8823529411764706,18.823529411764707,9,-0.011385199240986688,-7.7590132827324485,-14,0
2018,145,3138,63,3376,79,11,2,0.84375,13.3125,0.8125,15.53125,9,0.03125,-2.21875,-16,0
2018,146,3333,43,3257,76,6,1,0.7666666666666667,15.5,0.9411764705882353,19.647058823529413,5,-0.17450980392156856,-4.147058823529413,-33,0
2018,146,3417,73,3280,89,3,1,0.7741935483870968,12.64516129032258,0.9696969696969697,26.303030303030305,2,-0.19550342130987297,-13.657869012707724,-16,0
2018,147,3376,65,3163,94,2,1,0.8125,15.53125,1.0,36.90625,1,-0.1875,-21.375,-29,0
2018,147,3332,74,3323,84,2,1,0.8823529411764706,18.823529411764707,0.90625,18.5625,1,-0.023897058823529438,0.2610294117647065,-10,0
2018,151,3257,63,3280,73,1,1,0.9411764705882353,19.647058823529413,0.9696969696969697,26.303030303030305,0,-0.028520499108734443,-6.6559714795008915,-10,0
2018,151,3163,89,3323,91,1,1,1.0,36.90625,0.90625,18.5625,0,0.09375,18.34375,-2,0
2018,153,3280,58,3323,61,1,1,0.9696969696969697,26.303030303030305,0.90625,18.5625,0,0.06344696969696972,7.7405303030303045,-3,0
2019,137,3416,45,3113,60,12,5,0.8125,6.03125,0.6666666666666666,8.1,7,0.14583333333333337,-2.0687499999999996,-15,0
2019,137,3353,71,3138,82,7,10,0.7096774193548387,6.483870967741935,0.71875,9.500000000000002,-3,-0.009072580645161255,-3.0161290322580667,-11,0
2019,137,3377,66,3155,79,8,9,0.8387096774193549,16.258064516129032,0.6129032258064516,2.6129032258064515,-1,0.22580645161290325,13.64516129032258,-13,0
2019,137,3406,61,3163,110,15,2,0.625,1.5,0.9393939393939394,28.03030303030303,13,-0.31439393939393945,-26.53030303030303,-49,0
2019,137,3137,67,3199,70,12,5,0.8484848484848485,15.121212121212121,0.7419354838709677,7.935483870967742,7,0.10654936461388076,7.185728250244379,-3,0
2019,137,3400,65,3231,69,7,10,0.71875,8.937499999999998,0.625,4.375,-3,0.09375,4.562499999999998,-4,0
2019,137,3273,61,3234,66,15,2,0.78125,6.5,0.8125,12.25,13,-0.03125,-5.75,-5,0
2019,137,3352,34,3257,69,16,1,0.6774193548387096,7.67741935483871,0.90625,18.59375,15,-0.22883064516129037,-10.91633064516129,-35,0
2019,137,3349,54,3266,58,12,5,0.9032258064516129,13.548387096774194,0.7878787878787878,21.272727272727273,7,0.11534701857282503,-7.724340175953079,-4,0
2019,137,3195,62,3274,69,13,4,0.8666666666666667,17.8,0.75,10.5,9,0.1166666666666667,7.300000000000001,-7,0
2019,137,3243,54,3276,84,9,8,0.65625,1.0,0.65625,8.3125,1,0.0,-7.3125,-30,0
2019,137,3380,46,3280,103,16,1,0.6071428571428571,-2.857142857142857,0.9375,28.34375,15,-0.3303571428571429,-31.200892857142858,-57,0
2019,137,3179,76,3281,77,10,7,0.8125,13.28125,0.696969696969697,8.030303030303031,3,0.11553030303030298,5.250946969696969,-1,0
2019,137,3340,40,3332,78,15,2,0.7741935483870968,10.612903225806452,0.875,21.40625,13,-0.10080645161290325,-10.793346774193548,-38,0
2019,137,3125,52,3376,74,13,4,0.8125,16.09375,0.7,9.233333333333333,9,0.11250000000000004,6.8604166666666675,-22,0
2019,137,3460,61,3401,84,13,4,0.8125,8.375,0.7741935483870968,9.741935483870968,9,0.03830645161290325,-1.366935483870968,-23,0
2019,138,3101,38,3124,95,16,1,0.6785714285714286,6.392857142857143,0.96875,25.9375,15,-0.2901785714285714,-19.544642857142858,-57,0
2019,138,3120,64,3140,73,10,7,0.7,8.233333333333333,0.8064516129032258,6.451612903225806,3,-0.1064516129032258,1.7817204301075265,-9,0
2019,138,3314,72,3143,92,9,8,0.5625,4.28125,0.6129032258064516,3.4838709677419355,1,-0.050403225806451624,0.7973790322580645,-20,0
2019,138,3114,51,3211,68,12,5,0.6774193548387096,5.225806451612903,0.875,15.03125,7,-0.19758064516129037,-9.805443548387096,-17,0
2019,138,3308,61,3235,97,14,3,0.8,7.333333333333333,0.7575757575757576,14.969696969696969,11,0.042424242424242475,-7.636363636363636,-36,0
2019,138,3343,77,3246,82,11,6,0.7096774193548387,7.645161290322581,0.7741935483870968,13.548387096774194,5,-0.06451612903225801,-5.903225806451613,-5,0
2019,138,3347,51,3268,73,14,3,0.8064516129032258,9.193548387096774,0.875,14.187500000000002,11,-0.06854838709677424,-4.993951612903228,-22,0
2019,138,3141,87,3277,88,8,9,0.78125,14.6875,0.6451612903225806,7.774193548387097,-1,0.13608870967741937,6.913306451612903,-1,0
2019,138,3177,78,3283,89,6,11,0.7878787878787878,8.757575757575758,0.71875,10.1875,-5,0.06912878787878785,-1.4299242424242422,-11,0
2019,138,3263,51,3301,63,14,3,0.78125,9.875,0.8387096774193549,10.870967741935484,11,-0.05745967741935487,-0.995967741935484,-12,0
2019,138,3126,50,3323,92,16,1,0.6551724137931034,1.4137931034482758,0.9090909090909091,25.0,15,-0.25391849529780564,-23.586206896551722,-42,0
2019,138,3129,75,3333,80,13,4,0.8666666666666667,8.766666666666667,0.7741935483870968,15.387096774193548,9,0.09247311827956994,-6.6204301075268805,-5,0
2019,138,3346,65,3355,76,11,6,0.8125,14.71875,0.8125,17.53125,5,0.0,-2.8125,-11,0
2019,138,3413,54,3390,79,15,2,0.8,14.333333333333334,0.875,13.999999999999998,13,-0.07499999999999996,0.3333333333333357,-25,0
2019,138,3200,49,3393,70,14,3,0.7575757575757576,6.606060606060606,0.75,10.3125,11,0.007575757575757569,-3.7064393939393936,-21,0
2019,138,3397,77,3417,89,11,6,0.6129032258064516,6.096774193548387,0.625,5.15625,5,-0.012096774193548376,0.940524193548387,-12,0
2019,139,3274,55,3113,57,4,5,0.75,10.5,0.6666666666666666,8.1,-1,0.08333333333333337,2.4000000000000004,-2,0
2019,139,3138,72,3163,84,10,2,0.71875,9.500000000000002,0.9393939393939394,28.03030303030303,8,-0.22064393939393945,-18.53030303030303,-12,0
2019,139,3281,52,3234,68,7,2,0.696969696969697,8.030303030303031,0.8125,12.25,5,-0.11553030303030298,-4.219696969696969,-16,0
2019,139,3276,50,3257,71,8,1,0.65625,8.3125,0.90625,18.59375,7,-0.25,-10.28125,-21,0
2019,139,3155,61,3280,85,9,1,0.6129032258064516,2.6129032258064515,0.9375,28.34375,8,-0.3245967741935484,-25.730846774193548,-24,0
2019,139,3231,68,3332,91,10,2,0.625,4.375,0.875,21.40625,8,-0.25,-17.03125,-23,0
2019,139,3199,64,3376,72,5,4,0.7419354838709677,7.935483870967742,0.7,9.233333333333333,1,0.041935483870967794,-1.2978494623655905,-8,0
2019,139,3266,76,3401,78,5,4,0.7878787878787878,21.272727272727273,0.7741935483870968,9.741935483870968,1,0.013685239491691092,11.530791788856305,-2,0
2019,140,3143,63,3124,102,8,1,0.6129032258064516,3.4838709677419355,0.96875,25.9375,7,-0.3558467741935484,-22.453629032258064,-39,0
2019,140,3235,60,3283,69,3,11,0.7575757575757576,14.969696969696969,0.71875,10.1875,-8,0.03882575757575757,4.782196969696969,-9,0
2019,140,3246,57,3301,72,6,3,0.7741935483870968,13.548387096774194,0.8387096774193549,10.870967741935484,3,-0.06451612903225812,2.67741935483871,-15,0
2019,140,3277,63,3323,91,9,1,0.6451612903225806,7.774193548387097,0.9090909090909091,25.0,8,-0.26392961876832843,-17.225806451612904,-28,0
2019,140,3211,70,3333,76,5,4,0.875,15.03125,0.7741935483870968,15.387096774193548,1,0.10080645161290325,-0.35584677419354804,-6,0
2019,140,3393,64,3355,75,3,6,0.75,10.3125,0.8125,17.53125,-3,-0.0625,-7.21875,-11,0
2019,140,3140,63,3390,72,7,2,0.8064516129032258,6.451612903225806,0.875,13.999999999999998,5,-0.06854838709677424,-7.548387096774192,-9,0
2019,140,3268,80,3417,85,3,6,0.875,14.187500000000002,0.625,5.15625,-3,0.25,9.031250000000002,-5,0
2019,144,3417,61,3163,69,6,2,0.625,5.15625,0.9393939393939394,28.03030303030303,4,-0.31439393939393945,-22.87405303030303,-8,0
2019,144,3333,44,3257,61,4,1,0.7741935483870968,15.387096774193548,0.90625,18.59375,3,-0.13205645161290325,-3.206653225806452,-17,0
2019,144,3113,53,3280,76,5,1,0.6666666666666666,8.1,0.9375,28.34375,4,-0.27083333333333337,-20.24375,-23,0
2019,144,3355,53,3332,63,6,2,0.8125,17.53125,0.875,21.40625,4,-0.0625,-3.875,-10,0
2019,145,3376,68,3124,93,4,1,0.7,9.233333333333333,0.96875,25.9375,3,-0.26875000000000004,-16.704166666666666,-25,0
2019,145,3301,61,3234,79,3,2,0.8387096774193549,10.870967741935484,0.8125,12.25,1,0.02620967741935487,-1.379032258064516,-18,0
2019,145,3401,80,3323,87,4,1,0.7741935483870968,9.741935483870968,0.9090909090909091,25.0,3,-0.1348973607038123,-15.258064516129032,-7,0
2019,145,3283,46,3390,55,11,2,0.71875,10.1875,0.875,13.999999999999998,9,-0.15625,-3.8124999999999982,-9,0
2019,146,3257,73,3163,80,1,2,0.90625,18.59375,0.9393939393939394,28.03030303030303,-1,-0.03314393939393945,-9.436553030303031,-7,0
2019,146,3280,84,3332,88,1,2,0.9375,28.34375,0.875,21.40625,-1,0.0625,6.9375,-4,0
2019,147,3234,53,3124,85,2,1,0.8125,12.25,0.96875,25.9375,1,-0.15625,-13.6875,-32,0
2019,147,3390,68,3323,84,2,1,0.875,13.999999999999998,0.9090909090909091,25.0,1,-0.03409090909090906,-11.000000000000002,-16,0
2019,151,3332,67,3124,72,2,1,0.875,21.40625,0.96875,25.9375,1,-0.09375,-4.53125,-5,0
2019,151,3163,76,3323,81,2,1,0.9393939393939394,28.03030303030303,0.9090909090909091,25.0,1,0.030303030303030387,3.030303030303031,-5,0
2019,153,3323,81,3124,82,1,1,0.9090909090909091,25.0,0.96875,25.9375,0,-0.05965909090909094,-0.9375,-1,0
2021,139,3238,52,3124,101,15,2,0.782608695652174,9.869565217391305,0.9259259259259259,27.11111111111111,13,-0.14331723027375198,-17.241545893719806,-49,0
2021,139,3219,59,3163,102,16,1,0.7692307692307693,9.923076923076923,0.96,31.52,15,-0.1907692307692307,-21.596923076923076,-43,0
2021,139,3372,52,3210,54,12,5,0.9166666666666666,28.708333333333332,0.6521739130434783,4.217391304347826,7,0.26449275362318836,24.490942028985508,-2,0
2021,139,3141,72,3234,87,12,5,0.6923076923076923,4.076923076923077,0.6666666666666666,6.111111111111111,7,0.02564102564102566,-2.034188034188034,-15,0
2021,139,3226,63,3246,71,13,4,0.875,12.125,0.68,7.28,9,0.19499999999999995,4.845,-8,0
2021,139,3195,66,3276,87,11,6,0.9230769230769231,22.23076923076923,0.7368421052631579,10.368421052631579,5,0.18623481781376527,11.862348178137651,-21,0
2021,139,3299,58,3301,79,16,1,0.8666666666666667,17.0,0.9090909090909091,15.772727272727273,15,-0.042424242424242364,1.2272727272727266,-21,0
2021,139,3448,61,3329,84,9,8,0.5,-1.2083333333333333,0.6923076923076923,9.0,1,-0.1923076923076923,-10.208333333333334,-23,0
2021,139,3199,59,3333,83,9,8,0.5555555555555556,0.7777777777777778,0.5882352941176471,1.3529411764705883,1,-0.0326797385620915,-0.5751633986928105,-24,0
2021,139,3273,53,3376,79,16,1,0.75,7.958333333333333,0.8461538461538461,17.5,15,-0.09615384615384615,-9.541666666666668,-26,0
2021,139,3450,53,3378,57,9,8,0.5217391304347826,-0.043478260869565216,0.8571428571428571,11.333333333333334,1,-0.3354037267080745,-11.376811594202898,-4,0
2021,139,3430,44,3390,87,16,1,0.6666666666666666,3.2777777777777777,0.9259259259259259,25.703703703703702,15,-0.2592592592592593,-22.425925925925924,-43,0
2021,139,3355,55,3393,72,9,8,0.875,10.166666666666666,0.6190476190476191,2.857142857142857,1,0.25595238095238093,7.309523809523808,-17,0
2021,139,3292,62,3397,87,14,3,0.7083333333333334,4.916666666666667,0.6956521739130435,9.73913043478261,11,0.012681159420289911,-4.822463768115942,-25,0
2021,139,3266,63,3439,70,10,7,0.76,9.4,0.6086956521739131,8.08695652173913,3,0.15130434782608693,1.3130434782608695,-7,0
2021,139,3250,53,3452,77,13,4,0.6428571428571429,5.214285714285714,0.7777777777777778,6.518518518518518,9,-0.13492063492063489,-1.3042328042328037,-24,0
2021,140,3314,71,3104,80,10,7,0.5652173913043478,8.08695652173913,0.64,4.76,3,-0.07478260869565223,3.326956521739131,-9,0
2021,140,3392,44,3112,79,14,3,0.75,9.6,0.7619047619047619,10.523809523809524,11,-0.011904761904761862,-0.9238095238095241,-35,0
2021,140,3211,59,3125,64,5,12,0.8846153846153846,16.576923076923077,0.8,12.32,-7,0.08461538461538454,4.256923076923076,-5,0
2021,140,3353,66,3140,69,6,11,0.7777777777777778,18.5,0.782608695652174,10.130434782608695,-5,-0.004830917874396157,8.369565217391305,-3,0
2021,140,3180,53,3208,67,14,3,0.6363636363636364,4.2272727272727275,0.7692307692307693,11.384615384615385,11,-0.13286713286713292,-7.1573426573426575,-14,0
2021,140,3433,32,3231,63,13,4,0.6,2.4,0.782608695652174,15.173913043478262,9,-0.18260869565217397,-12.773913043478261,-31,0
2021,140,3277,75,3235,79,10,7,0.6521739130434783,6.869565217391305,0.6153846153846154,5.923076923076923,3,0.03678929765886285,0.9464882943143813,-4,0
2021,140,3265,43,3257,74,15,2,0.8571428571428571,13.571428571428571,0.8846153846153846,16.884615384615383,13,-0.027472527472527486,-3.313186813186812,-31,0
2021,140,3291,45,3268,98,15,2,0.7272727272727273,11.863636363636363,0.9230769230769231,21.0,13,-0.19580419580419584,-9.136363636363637,-53,0
2021,140,3413,51,3283,70,12,5,0.8666666666666667,9.533333333333333,0.9090909090909091,11.818181818181818,7,-0.042424242424242364,-2.284848484848485,-19,0
2021,140,3416,51,3321,62,10,7,0.8,8.15,0.6521739130434783,6.695652173913044,3,0.14782608695652177,1.4543478260869565,-11,0
2021,140,3377,47,3332,67,11,6,0.782608695652174,14.869565217391305,0.6190476190476191,12.476190476190476,5,0.16356107660455488,2.3933747412008284,-20,0
2021,140,3133,62,3400,81,11,6,0.5925925925925926,4.592592592592593,0.6666666666666666,7.074074074074074,5,-0.07407407407407407,-2.481481481481482,-19,0
2021,140,3407,80,3401,84,15,2,0.8,11.4,0.92,14.48,13,-0.12,-3.08,-4,0
2021,140,3461,48,3417,69,14,3,0.6086956521739131,4.434782608695652,0.7619047619047619,13.80952380952381,11,-0.15320910973084878,-9.374741200828158,-21,0
2021,140,3116,62,3460,66,4,13,0.7037037037037037,9.0,0.72,8.2,-9,-0.016296296296296253,0.8000000000000007,-4,0
2021,141,3439,48,3124,90,7,2,0.6086956521739131,8.08695652173913,0.9259259259259259,27.11111111111111,5,-0.31723027375201285,-19.02415458937198,-42,0
2021,141,3393,47,3163,83,8,1,0.6190476190476191,2.857142857142857,0.96,31.52,7,-0.3409523809523809,-28.662857142857142,-36,0
2021,141,3452,56,3210,73,4,5,0.7777777777777778,6.518518518518518,0.6521739130434783,4.217391304347826,-1,0.12560386473429952,2.301127214170692,-17,0
2021,141,3246,72,3234,86,4,5,0.68,7.28,0.6666666666666666,6.111111111111111,-1,0.01333333333333342,1.1688888888888895,-14,0
2021,141,3397,55,3276,70,3,6,0.6956521739130435,9.73913043478261,0.7368421052631579,10.368421052631579,-3,-0.041189931350114395,-0.6292906178489694,-15,0
2021,141,3378,67,3301,79,8,1,0.8571428571428571,11.333333333333334,0.9090909090909091,15.772727272727273,7,-0.051948051948051965,-4.4393939393939394,-12,0
2021,141,3333,42,3376,59,8,1,0.5882352941176471,1.3529411764705883,0.8461538461538461,17.5,7,-0.25791855203619907,-16.147058823529413,-17,0
2021,141,3329,62,3390,73,8,1,0.6923076923076923,9.0,0.9259259259259259,25.703703703703702,7,-0.23361823361823364,-16.703703703703702,-11,0
2021,142,3140,46,3112,52,11,3,0.782608695652174,10.130434782608695,0.7619047619047619,10.523809523809524,8,0.020703933747412084,-0.3933747412008284,-6,0
2021,142,3125,48,3231,70,12,4,0.8,12.32,0.782608695652174,15.173913043478262,8,0.017391304347826098,-2.8539130434782614,-22,0
2021,142,3321,53,3257,62,7,2,0.6521739130434783,6.695652173913044,0.8846153846153846,16.884615384615383,5,-0.2324414715719063,-10.18896321070234,-9,0
2021,142,3104,64,3268,100,7,2,0.64,4.76,0.9230769230769231,21.0,5,-0.2830769230769231,-16.240000000000002,-36,0
2021,142,3460,39,3283,64,13,5,0.72,8.2,0.9090909090909091,11.818181818181818,8,-0.1890909090909091,-3.618181818181819,-25,0
2021,142,3208,50,3332,57,3,6,0.7692307692307693,11.384615384615385,0.6190476190476191,12.476190476190476,-3,0.1501831501831502,-1.0915750915750912,-7,0
2021,142,3417,62,3400,71,3,6,0.7619047619047619,13.80952380952381,0.6666666666666666,7.074074074074074,-3,0.09523809523809523,6.735449735449736,-9,0
2021,142,3235,82,3401,84,7,2,0.6153846153846154,5.923076923076923,0.92,14.48,5,-0.3046153846153846,-8.556923076923077,-2,0
2021,145,3401,59,3112,74,2,3,0.92,14.48,0.7619047619047619,10.523809523809524,-1,0.15809523809523818,3.9561904761904767,-15,0
2021,145,3276,75,3124,78,6,2,0.7368421052631579,10.368421052631579,0.9259259259259259,27.11111111111111,4,-0.18908382066276808,-16.742690058479532,-3,0
2021,145,3234,72,3163,92,5,1,0.6666666666666666,6.111111111111111,0.96,31.52,4,-0.29333333333333333,-25.40888888888889,-20,0
2021,145,3301,70,3231,73,1,4,0.9090909090909091,15.772727272727273,0.782608695652174,15.173913043478262,-3,0.1264822134387351,0.5988142292490117,-3,0
2021,146,3332,42,3257,60,6,2,0.6190476190476191,12.476190476190476,0.8846153846153846,16.884615384615383,4,-0.2655677655677655,-4.408424908424907,-18,0
2021,146,3210,65,3376,76,5,1,0.6521739130434783,4.217391304347826,0.8461538461538461,17.5,4,-0.19397993311036787,-13.282608695652174,-11,0
2021,146,3283,62,3390,89,5,1,0.9090909090909091,11.818181818181818,0.9259259259259259,25.703703703703702,4,-0.01683501683501687,-13.885521885521884,-27,0
2021,146,3268,61,3400,64,2,6,0.9230769230769231,21.0,0.6666666666666666,7.074074074074074,-4,0.2564102564102565,13.925925925925926,-3,0
2021,147,3231,53,3112,66,4,3,0.782608695652174,15.173913043478262,0.7619047619047619,10.523809523809524,1,0.020703933747412084,4.650103519668738,-13,0
2021,147,3124,67,3163,69,2,1,0.9259259259259259,27.11111111111111,0.96,31.52,1,-0.034074074074074034,-4.408888888888889,-2,0
2021,148,3400,34,3376,62,6,1,0.6666666666666666,7.074074074074074,0.8461538461538461,17.5,5,-0.17948717948717952,-10.425925925925926,-28,0
2021,148,3257,63,3390,78,2,1,0.8846153846153846,16.884615384615383,0.9259259259259259,25.703703703703702,1,-0.04131054131054135,-8.81908831908832,-15,0
2021,151,3163,59,3112,69,1,3,0.96,31.52,0.7619047619047619,10.523809523809524,-2,0.1980952380952381,20.996190476190478,-10,0
2021,151,3376,65,3390,66,1,1,0.8461538461538461,17.5,0.9259259259259259,25.703703703703702,0,-0.07977207977207978,-8.203703703703702,-1,0
2021,153,3112,53,3390,54,3,1,0.7619047619047619,10.523809523809524,0.9259259259259259,25.703703703703702,2,-0.16402116402116407,-15.179894179894179,-1,0
2022,135,3177,57,3173,88,11,11,0.6875,10.0,0.8333333333333334,10.766666666666667,0,-0.14583333333333337,-0.7666666666666675,-31,0
2022,135,3230,51,3224,55,16,16,0.4074074074074074,-3.5185185185185186,0.6785714285714286,3.392857142857143,0,-0.2711640211640212,-6.911375661375661,-4,0
2022,136,3291,70,3255,74,16,16,0.5384615384615384,0.4230769230769231,0.65625,4.3125,0,-0.11778846153846156,-3.889423076923077,-4,0
2022,136,3199,50,3283,61,11,11,0.5666666666666667,4.133333333333334,0.7666666666666667,10.033333333333333,0,-0.20000000000000007,-5.8999999999999995,-11,0
2022,137,3218,49,3124,89,15,2,0.6896551724137931,1.4827586206896552,0.8181818181818182,16.515151515151516,13,-0.12852664576802508,-15.03239289446186,-40,0
2022,137,3160,74,3166,84,7,10,0.7333333333333333,8.533333333333333,0.6896551724137931,11.379310344827585,-3,0.04367816091954013,-2.845977011494252,-10,0
2022,137,3439,81,3195,84,5,12,0.71875,12.875,0.9285714285714286,17.53571428571429,-7,-0.2098214285714286,-4.660714285714288,-3,0
2022,137,3173,54,3208,70,11,6,0.8333333333333334,10.766666666666667,0.6896551724137931,10.137931034482758,5,0.14367816091954022,0.6287356321839095,-16,0
2022,137,3304,55,3211,68,8,9,0.75,14.34375,0.8125,13.562500000000002,-1,-0.0625,0.7812499999999982,-13,0
2022,137,3229,58,3234,98,15,2,0.5806451612903226,0.967741935483871,0.7666666666666667,13.666666666666664,13,-0.1860215053763441,-12.698924731182792,-40,0
2022,137,3426,71,3235,78,14,3,0.7407407407407407,3.925925925925926,0.8125,13.125,11,-0.0717592592592593,-9.199074074074074,-7,0
2022,137,3210,58,3242,77,9,8,0.6774193548387096,9.161290322580646,0.6896551724137931,7.275862068965517,1,-0.012235817575083519,1.885428253615129,-19,0
2022,137,3107,51,3257,83,16,1,0.7096774193548387,7.354838709677419,0.8620689655172413,17.13793103448276,15,-0.15239154616240258,-9.783092324805342,-32,0
2022,137,3174,71,3268,102,13,4,0.7666666666666667,8.366666666666667,0.7241379310344828,11.10344827586207,9,0.042528735632183956,-2.7367816091954023,-31,0
2022,137,3378,66,3274,78,9,8,0.75,6.9375,0.625,2.78125,1,0.125,4.15625,-12,0
2022,137,3224,21,3376,79,16,1,0.6785714285714286,3.392857142857143,0.9354838709677419,19.612903225806452,15,-0.2569124423963133,-16.22004608294931,-58,0
2022,137,3279,61,3377,75,7,10,0.7419354838709677,11.161290322580646,0.8387096774193549,15.483870967741936,-3,-0.09677419354838712,-4.32258064516129,-14,0
2022,137,3286,37,3390,78,16,1,0.625,2.0,0.9032258064516129,16.903225806451612,15,-0.2782258064516129,-14.903225806451612,-41,0
2022,137,3193,52,3400,70,15,2,0.8064516129032258,8.516129032258064,0.8125,15.96875,13,-0.006048387096774244,-7.452620967741936,-18,0
2022,137,3116,69,3428,92,10,7,0.5806451612903226,8.03225806451613,0.6451612903225806,8.161290322580646,3,-0.06451612903225801,-0.12903225806451601,-23,0
2022,138,3424,67,3112,72,13,4,0.8125,11.09375,0.7407407407407407,11.037037037037036,9,0.0717592592592593,0.05671296296296369,-5,0
2022,138,3332,70,3125,73,5,12,0.6333333333333333,9.8,0.7586206896551724,13.965517241379313,-7,-0.12528735632183907,-4.1655172413793125,-3,0
2022,138,3273,38,3163,83,15,2,0.7931034482758621,9.344827586206897,0.8333333333333334,20.6,13,-0.04022988505747127,-11.255172413793105,-45,0
2022,138,3150,51,3231,85,14,3,0.7096774193548387,5.483870967741935,0.7333333333333333,9.9,11,-0.023655913978494536,-4.416129032258065,-34,0
2022,138,3450,40,3243,50,8,9,0.6551724137931034,0.41379310344827586,0.6129032258064516,6.516129032258065,-1,0.0422691879866518,-6.102335928809789,-10,0
2022,138,3238,77,3261,83,14,3,0.7931034482758621,17.724137931034484,0.8333333333333334,13.2,11,-0.04022988505747127,4.524137931034485,-6,0
2022,138,3110,39,3276,74,14,3,0.7419354838709677,4.0,0.7857142857142857,11.178571428571429,11,-0.04377880184331795,-7.178571428571429,-35,0
2022,138,3255,68,3301,96,16,1,0.65625,4.3125,0.90625,19.34375,15,-0.25,-15.03125,-28,0
2022,138,3372,66,3314,79,12,5,0.8666666666666667,16.533333333333335,0.7931034482758621,18.344827586206897,7,0.0735632183908046,-1.8114942528735618,-13,0
2022,138,3269,78,3323,89,12,5,0.8125,10.75,0.7333333333333333,10.366666666666667,7,0.07916666666666672,0.38333333333333286,-11,0
2022,138,3283,56,3326,63,11,6,0.7666666666666667,10.033333333333333,0.7931034482758621,13.241379310344827,5,-0.02643678160919538,-3.208045977011494,-7,0
2022,138,3237,72,3328,78,13,4,0.8571428571428571,14.75,0.75,7.28125,9,0.1071428571428571,7.46875,-6,0
2022,138,3246,62,3343,69,6,11,0.6333333333333333,6.966666666666667,0.8518518518518519,17.814814814814813,-5,-0.21851851851851856,-10.848148148148146,-7,0
2022,138,3138,67,3397,80,13,4,0.7575757575757576,9.848484848484848,0.7419354838709677,9.741935483870968,9,0.01564027370478982,0.10654936461387976,-13,0
2022,138,3196,52,3416,69,10,7,0.6774193548387096,3.903225806451613,0.8928571428571429,13.214285714285714,3,-0.21543778801843327,-9.3110599078341,-17,0
2022,138,3140,57,3437,61,6,11,0.896551724137931,19.586206896551722,0.7419354838709677,4.67741935483871,-5,0.1546162402669633,14.908787541713012,-4,0
2022,139,3234,62,3166,64,2,10,0.7666666666666667,13.666666666666664,0.6896551724137931,11.379310344827585,-8,0.07701149425287357,2.287356321839079,-2,0
2022,139,3208,44,3235,67,6,3,0.6896551724137931,10.137931034482758,0.8125,13.125,3,-0.12284482758620685,-2.987068965517242,-23,0
2022,139,3211,59,3257,68,9,1,0.8125,13.562500000000002,0.8620689655172413,17.13793103448276,8,-0.049568965517241326,-3.57543103448276,-9,0
2022,139,3195,65,3268,89,12,4,0.9285714285714286,17.53571428571429,0.7241379310344828,11.10344827586207,8,0.20443349753694584,6.432266009852219,-24,0
2022,139,3274,33,3376,49,8,1,0.625,2.78125,0.9354838709677419,19.612903225806452,7,-0.3104838709677419,-16.831653225806452,-16,0
2022,139,3124,47,3377,61,2,10,0.8181818181818182,16.515151515151516,0.8387096774193549,15.483870967741936,-8,-0.02052785923753664,1.0312805474095796,-14,0
2022,139,3242,65,3390,91,8,1,0.6896551724137931,7.275862068965517,0.9032258064516129,16.903225806451612,7,-0.21357063403781973,-9.627363737486096,-26,0
2022,139,3428,56,3400,78,7,2,0.6451612903225806,8.161290322580646,0.8125,15.96875,5,-0.16733870967741937,-7.807459677419354,-22,0
2022,140,3416,47,3163,52,7,2,0.8928571428571429,13.214285714285714,0.8333333333333334,20.6,5,0.059523809523809534,-7.385714285714288,-5,0
2022,140,3343,55,3231,56,11,3,0.8518518518518519,17.814814814814813,0.7333333333333333,9.9,8,0.11851851851851858,7.914814814814813,-1,0
2022,140,3437,49,3276,64,11,3,0.7419354838709677,4.67741935483871,0.7857142857142857,11.178571428571429,8,-0.04377880184331795,-6.501152073732719,-15,0
2022,140,3243,57,3301,89,9,1,0.6129032258064516,6.516129032258065,0.90625,19.34375,8,-0.2933467741935484,-12.827620967741936,-32,0
2022,140,3112,45,3314,63,4,5,0.7407407407407407,11.037037037037036,0.7931034482758621,18.344827586206897,-1,-0.0523627075351214,-7.3077905491698605,-18,0
2022,140,3328,64,3323,108,4,5,0.75,7.28125,0.7333333333333333,10.366666666666667,-1,0.01666666666666672,-3.085416666666667,-44,0
2022,140,3261,64,3326,79,3,6,0.8333333333333334,13.2,0.7931034482758621,13.241379310344827,-3,0.04022988505747127,-0.04137931034482811,-15,0
2022,140,3125,67,3397,70,12,4,0.7586206896551724,13.965517241379313,0.7419354838709677,9.741935483870968,8,0.016685205784204626,4.223581757508345,-3,0
2022,144,3235,68,3166,76,3,10,0.8125,13.125,0.6896551724137931,11.379310344827585,-7,0.12284482758620685,1.7456896551724146,-8,0
2022,144,3314,61,3376,69,5,1,0.7931034482758621,18.344827586206897,0.9354838709677419,19.612903225806452,4,-0.14238042269187978,-1.2680756395995552,-8,0
2022,144,3268,66,3390,72,4,1,0.7241379310344828,11.10344827586207,0.9032258064516129,16.903225806451612,3,-0.17908787541713012,-5.799777530589543,-6,0
2022,144,3326,63,3400,66,6,2,0.7931034482758621,13.241379310344827,0.8125,15.96875,4,-0.0193965517241379,-2.7273706896551726,-3,0
2022,145,3231,58,3163,75,3,2,0.7333333333333333,9.9,0.8333333333333334,20.6,1,-0.10000000000000009,-10.700000000000001,-17,0
2022,145,3397,64,3257,76,4,1,0.7419354838709677,9.741935483870968,0.8620689655172413,17.13793103448276,3,-0.12013348164627358,-7.395995550611794,-12,0
2022,145,3377,49,3276,52,10,3,0.8387096774193549,15.483870967741936,0.7857142857142857,11.178571428571429,7,0.05299539170506917,4.305299539170507,-3,0
2022,145,3323,63,3301,66,5,1,0.7333333333333333,10.366666666666667,0.90625,19.34375,4,-0.17291666666666672,-8.977083333333333,-3,0
2022,146,3166,50,3376,80,10,1,0.6896551724137931,11.379310344827585,0.9354838709677419,19.612903225806452,9,-0.24582869855394873,-8.233592880978867,-30,0
2022,146,3400,50,3390,59,2,1,0.8125,15.96875,0.9032258064516129,16.903225806451612,1,-0.09072580645161288,-0.9344758064516121,-9,0
2022,147,3301,87,3163,91,1,2,0.90625,19.34375,0.8333333333333334,20.6,-1,0.07291666666666663,-1.2562500000000014,-4,0
2022,147,3276,50,3257,62,3,1,0.7857142857142857,11.178571428571429,0.8620689655172413,17.13793103448276,2,-0.07635467980295563,-5.959359605911333,-12,0
2022,151,3390,58,3163,63,1,2,0.9032258064516129,16.903225806451612,0.8333333333333334,20.6,-1,0.06989247311827951,-3.6967741935483893,-5,0
2022,151,3257,59,3376,72,1,1,0.8620689655172413,17.13793103448276,0.9354838709677419,19.612903225806452,0,-0.07341490545050056,-2.4749721913236904,-13,0
2022,153,3163,49,3376,64,2,1,0.8333333333333334,20.6,0.9354838709677419,19.612903225806452,1,-0.10215053763440851,0.9870967741935495,-15,0
2016,134,1192,65,1195,96,16,16,0.5483870967741935,-1.6774193548387097,0.5517241379310345,2.7241379310344827,0,-0.0033370411568409697,-4.401557285873192,-31,0
2016,134,1435,50,1455,70,11,11,0.59375,9.40625,0.7419354838709677,13.709677419354838,0,-0.14818548387096775,-4.303427419354838,-20,0
2016,135,1380,55,1221,59,16,16,0.6129032258064516,1.8709677419354838,0.42424242424242425,-4.333333333333333,0,0.18866080156402737,6.204301075268817,-4,0
2016,135,1409,62,1276,67,11,11,0.6451612903225806,4.32258064516129,0.6363636363636364,6.242424242424244,0,0.008797653958944274,-1.919843597262954,-5,0
2016,136,1345,83,1114,85,5,12,0.7647058823529411,13.147058823529413,0.8709677419354839,9.935483870967742,-7,-0.10626185958254275,3.211574952561671,-2,0
2016,136,1403,61,1139,71,8,9,0.6129032258064516,2.5483870967741935,0.6774193548387096,9.419354838709678,-1,-0.06451612903225801,-6.870967741935484,-10,0
2016,136,1160,67,1163,74,8,9,0.65625,4.75,0.7058823529411765,10.323529411764707,-1,-0.049632352941176516,-5.5735294117647065,-7,0
2016,136,1423,85,1181,93,13,4,0.7666666666666667,6.366666666666666,0.696969696969697,9.393939393939394,9,0.0696969696969697,-3.0272727272727282,-8,0
2016,136,1371,52,1211,68,6,11,0.7575757575757576,7.0606060606060606,0.78125,12.75,-5,-0.02367424242424243,-5.6893939393939394,-16,0
2016,136,1151,74,1231,99,12,5,0.84375,7.6875,0.78125,13.374999999999998,7,0.0625,-5.687499999999998,-25,0
2016,136,1233,81,1235,94,13,4,0.6875,5.9375,0.65625,6.875,9,0.03125,-0.9375,-13,0
2016,136,1122,79,1242,105,16,1,0.48484848484848486,-2.3636363636363638,0.8787878787878788,12.696969696969697,15,-0.3939393939393939,-15.06060606060606,-26,0
2016,136,1392,57,1246,85,13,4,0.8,10.266666666666667,0.7647058823529411,11.411764705882353,9,0.03529411764705892,-1.1450980392156858,-28,0
2016,136,1138,72,1274,79,14,3,0.5757575757575758,0.6666666666666659,0.78125,8.8125,11,-0.2054924242424242,-8.145833333333334,-7,0
2016,136,1195,67,1314,83,16,1,0.5517241379310345,2.7241379310344827,0.8235294117647058,12.705882352941176,15,-0.27180527383367137,-9.981744421906694,-16,0
2016,136,1425,69,1344,70,8,9,0.6363636363636364,6.090909090909091,0.696969696969697,4.242424242424241,-1,-0.06060606060606066,1.8484848484848495,-1,0
2016,136,1201,69,1428,80,14,3,0.71875,3.468749999999999,0.7575757575757576,7.484848484848484,11,-0.03882575757575757,-4.016098484848485,-11,0
2016,136,1214,45,1438,81,16,1,0.6666666666666666,0.9,0.7878787878787878,10.696969696969697,15,-0.12121212121212122,-9.796969696969697,-36,0
2016,136,1112,55,1455,65,6,11,0.7575757575757576,12.212121212121215,0.7419354838709677,13.709677419354838,-5,0.01564027370478982,-1.4975562072336235,-10,0
2016,136,1124,75,1463,79,5,12,0.65625,6.6875,0.7777777777777778,10.962962962962964,-7,-0.12152777777777779,-4.275462962962964,-4,0
2016,137,1143,66,1218,77,4,13,0.696969696969697,8.090909090909092,0.8333333333333334,10.8,-9,-0.13636363636363635,-2.709090909090909,-11,0
2016,137,1396,70,1234,72,10,7,0.65625,1.2187499999999991,0.6774193548387096,9.387096774193548,3,-0.02116935483870963,-8.168346774193548,-2,0
2016,137,1355,74,1268,79,12,5,0.7741935483870968,7.032258064516129,0.75,9.125,7,0.024193548387096753,-2.092741935483871,-5,0
2016,137,1277,81,1292,90,2,15,0.8529411764705882,16.38235294117647,0.7096774193548387,4.096774193548387,-13,0.14326375711574946,12.285578747628083,-9,0
2016,137,1400,72,1320,75,6,11,0.625,3.28125,0.6363636363636364,4.636363636363637,-5,-0.011363636363636354,-1.3551136363636367,-3,0
2016,137,1276,63,1323,70,11,6,0.6363636363636364,6.242424242424244,0.65625,5.125,5,-0.019886363636363646,1.117424242424244,-7,0
2016,137,1167,68,1328,82,15,2,0.7241379310344828,8.482758620689655,0.78125,9.96875,13,-0.05711206896551724,-1.4859913793103452,-14,0
2016,137,1221,52,1332,91,16,1,0.42424242424242425,-4.333333333333333,0.8181818181818182,9.151515151515152,15,-0.393939393939394,-13.484848484848484,-39,0
2016,137,1452,56,1372,70,3,14,0.7647058823529411,12.588235294117647,0.8214285714285714,15.285714285714283,-11,-0.05672268907563027,-2.697478991596636,-14,0
2016,137,1153,76,1386,78,9,8,0.6875,10.312499999999998,0.7941176470588235,7.676470588235294,1,-0.10661764705882348,2.636029411764704,-2,0
2016,137,1173,51,1393,70,7,10,0.78125,7.375,0.59375,4.5,-3,0.1875,2.875,-19,0
2016,137,1453,65,1401,92,14,3,0.6363636363636364,2.696969696969697,0.7647058823529411,10.382352941176471,11,-0.12834224598930477,-7.685383244206774,-27,0
2016,137,1333,67,1433,75,7,10,0.6,1.4333333333333333,0.7058823529411765,9.911764705882353,-3,-0.10588235294117654,-8.47843137254902,-8,0
2016,137,1421,56,1437,86,15,2,0.6451612903225806,5.451612903225806,0.8529411764705882,13.264705882352942,13,-0.20777988614800758,-7.813092979127136,-30,0
2016,137,1338,43,1458,47,10,7,0.6451612903225806,7.064516129032258,0.625,4.3125,3,0.020161290322580627,2.752016129032258,-4,0
2016,137,1451,53,1462,71,15,2,0.7419354838709677,6.064516129032259,0.84375,10.3125,13,-0.10181451612903225,-4.247983870967741,-18,0
2016,138,1463,64,1181,71,12,4,0.7777777777777778,10.962962962962964,0.696969696969697,9.393939393939394,8,0.08080808080808077,1.5690235690235692,-7,0
2016,138,1428,59,1211,82,3,11,0.7575757575757576,7.484848484848484,0.78125,12.75,-8,-0.02367424242424243,-5.265151515151516,-23,0
2016,138,1246,67,1231,73,4,5,0.7647058823529411,11.411764705882353,0.78125,13.374999999999998,-1,-0.016544117647058876,-1.963235294117645,-6,0
2016,138,1114,61,1235,78,12,4,0.8709677419354839,9.935483870967742,0.65625,6.875,8,0.21471774193548387,3.060483870967742,-17,0
2016,138,1163,61,1242,73,9,1,0.7058823529411765,10.323529411764707,0.8787878787878788,12.696969696969697,8,-0.17290552584670227,-2.3734402852049907,-12,0
2016,138,1455,57,1274,65,11,3,0.7419354838709677,13.709677419354838,0.78125,8.8125,8,-0.03931451612903225,4.897177419354838,-8,0
2016,138,1344,66,1314,85,9,1,0.696969696969697,4.242424242424241,0.8235294117647058,12.705882352941176,8,-0.12655971479500883,-8.463458110516935,-19,0
2016,138,1139,69,1438,77,9,1,0.6774193548387096,9.419354838709678,0.7878787878787878,10.696969696969697,8,-0.11045943304007821,-1.2776148582600193,-8,0
2016,139,1218,60,1268,73,13,5,0.8333333333333334,10.8,0.75,9.125,8,0.08333333333333337,1.6750000000000007,-13,0
2016,139,1372,75,1323,76,14,6,0.8214285714285714,15.285714285714283,0.65625,5.125,8,0.1651785714285714,10.160714285714283,-1,0
2016,139,1433,81,1328,85,10,2,0.7058823529411765,9.911764705882353,0.78125,9.96875,8,-0.07536764705882348,-0.056985294117646745,-4,0
2016,139,1386,64,1332,69,8,1,0.7941176470588235,7.676470588235294,0.8181818181818182,9.151515151515152,7,-0.02406417112299475,-1.475044563279858,-5,0
2016,139,1292,50,1393,75,15,10,0.7096774193548387,4.096774193548387,0.59375,4.5,5,0.11592741935483875,-0.403225806451613,-25,0
2016,139,1320,88,1401,92,11,3,0.6363636363636364,4.636363636363637,0.7647058823529411,10.382352941176471,8,-0.12834224598930477,-5.745989304812834,-4,0
2016,139,1234,68,1437,87,7,2,0.6774193548387096,9.387096774193548,0.8529411764705882,13.264705882352942,5,-0.17552182163187857,-3.877609108159394,-19,0
2016,139,1462,63,1458,66,2,7,0.84375,10.3125,0.625,4.3125,-5,0.21875,6.0,-3,0
2016,143,1268,63,1242,79,5,1,0.75,9.125,0.8787878787878788,12.696969696969697,4,-0.12878787878787878,-3.5719696969696972,-16,0
2016,143,1401,63,1328,77,3,2,0.7647058823529411,10.382352941176471,0.78125,9.96875,1,-0.016544117647058876,0.413602941176471,-14,0
2016,143,1181,68,1332,82,4,1,0.696969696969697,9.393939393939394,0.8181818181818182,9.151515151515152,3,-0.12121212121212122,0.2424242424242422,-14,0
2016,143,1274,69,1437,92,3,2,0.78125,8.8125,0.8529411764705882,13.264705882352942,1,-0.0716911764705882,-4.452205882352942,-23,0
2016,144,1231,86,1314,101,5,1,0.78125,13.374999999999998,0.8235294117647058,12.705882352941176,4,-0.04227941176470584,0.6691176470588225,-15,0
2016,144,1458,56,1323,61,7,6,0.625,4.3125,0.65625,5.125,1,-0.03125,-0.8125,-5,0
2016,144,1211,60,1393,63,11,10,0.78125,12.75,0.59375,4.5,1,0.1875,8.25,-3,0
2016,144,1235,71,1438,84,4,1,0.65625,6.875,0.7878787878787878,10.696969696969697,3,-0.13162878787878785,-3.8219696969696972,-13,0
2016,145,1332,68,1328,80,1,2,0.8181818181818182,9.151515151515152,0.78125,9.96875,-1,0.03693181818181823,-0.8172348484848477,-12,0
2016,145,1242,59,1437,64,1,2,0.8787878787878788,12.696969696969697,0.8529411764705882,13.264705882352942,-1,0.025846702317290582,-0.5677361853832448,-5,0
2016,146,1323,74,1314,88,6,1,0.65625,5.125,0.8235294117647058,12.705882352941176,5,-0.16727941176470584,-7.580882352941176,-14,0
2016,146,1438,62,1393,68,1,10,0.7878787878787878,10.696969696969697,0.59375,4.5,-9,0.19412878787878785,6.196969696969697,-6,0
2016,152,1393,66,1314,83,10,1,0.59375,4.5,0.8235294117647058,12.705882352941176,9,-0.22977941176470584,-8.205882352941176,-17,0
2016,152,1328,51,1437,95,2,2,0.78125,9.96875,0.8529411764705882,13.264705882352942,0,-0.0716911764705882,-3.295955882352942,-44,0
2016,154,1314,74,1437,77,1,2,0.8235294117647058,12.705882352941176,0.8529411764705882,13.264705882352942,-1,-0.02941176470588236,-0.5588235294117663,-3,0
2017,134,1448,88,1243,95,11,11,0.59375,4.75,0.6060606060606061,4.787878787878788,0,-0.012310606060606077,-0.03787878787878807,-7,0
2017,134,1309,66,1291,67,16,16,0.6071428571428571,1.3214285714285714,0.5588235294117647,-0.2647058823529412,0,0.048319327731092376,1.5861344537815125,-1,0
2017,135,1300,63,1413,67,16,16,0.7333333333333333,9.433333333333334,0.625,0.5,0,0.10833333333333328,8.933333333333334,-4,0
2017,135,1344,71,1425,75,11,11,0.625,3.625,0.7272727272727273,5.515151515151516,0,-0.10227272727272729,-1.8901515151515156,-4,0
2017,136,1315,82,1112,100,15,2,0.6785714285714286,4.3928571428571415,0.8823529411764706,10.823529411764707,13,-0.20378151260504196,-6.430672268907565,-18,0
2017,136,1457,64,1139,76,13,4,0.8,8.1,0.7419354838709677,7.903225806451613,9,0.058064516129032295,0.19677419354838666,-12,0
2017,136,1190,65,1196,80,13,4,0.78125,10.1875,0.75,11.71875,9,0.03125,-1.53125,-15,0
2017,136,1195,80,1199,86,14,3,0.7666666666666667,6.066666666666666,0.7575757575757576,11.18181818181818,11,0.00909090909090915,-5.1151515151515135,-6,0
2017,136,1355,46,1211,66,16,1,0.5,-1.0625,0.9696969696969697,23.424242424242426,15,-0.4696969696969697,-24.486742424242426,-20,0
2017,136,1305,73,1235,84,12,5,0.8235294117647058,9.029411764705882,0.696969696969697,8.878787878787879,7,0.12655971479500883,0.15062388591800335,-11,0
2017,136,1278,72,1292,81,5,12,0.7272727272727273,6.181818181818182,0.8787878787878788,10.909090909090908,-7,-0.1515151515151515,-4.727272727272727,-9,0
2017,136,1435,66,1321,68,9,8,0.5588235294117647,3.1176470588235294,0.6764705882352942,6.029411764705882,1,-0.11764705882352944,-2.911764705882353,-2,0
2017,136,1343,58,1323,60,12,5,0.7857142857142857,8.785714285714286,0.7352941176470589,8.794117647058824,7,0.05042016806722682,-0.008403361344537785,-2,0
2017,136,1436,70,1345,80,13,4,0.8484848484848485,10.545454545454545,0.78125,12.96875,9,0.06723484848484851,-2.423295454545455,-10,0
2017,136,1433,77,1388,85,10,7,0.7647058823529411,8.264705882352942,0.875,15.5,3,-0.11029411764705888,-7.235294117647058,-8,0
2017,136,1291,56,1437,76,16,1,0.5588235294117647,-0.2647058823529412,0.9117647058823529,14.882352941176471,15,-0.3529411764705882,-15.147058823529413,-20,0
2017,136,1423,71,1438,76,12,5,0.84375,9.03125,0.6875,10.96875,7,0.15625,-1.9375,-5,0
2017,136,1137,80,1452,86,13,4,0.7647058823529411,8.794117647058824,0.7647058823529411,15.647058823529411,9,0.0,-6.852941176470587,-6,0
2017,136,1439,74,1458,84,9,8,0.6875,4.84375,0.7352941176470589,10.529411764705882,1,-0.047794117647058876,-5.685661764705882,-10,0
2017,136,1268,65,1462,76,6,11,0.7419354838709677,5.0,0.6176470588235294,3.264705882352941,-5,0.12428842504743831,1.7352941176470589,-11,0
2017,137,1371,71,1116,77,9,8,0.65625,3.1249999999999996,0.7352941176470589,5.794117647058823,1,-0.07904411764705888,-2.669117647058824,-6,0
2017,137,1308,73,1124,91,14,3,0.8333333333333334,9.366666666666667,0.7741935483870968,8.580645161290322,11,0.05913978494623662,0.7860215053763451,-18,0
2017,137,1243,61,1153,75,11,6,0.6060606060606061,4.787878787878788,0.8529411764705882,13.647058823529411,5,-0.24688057040998213,-8.859180035650624,-14,0
2017,137,1407,65,1181,87,15,2,0.5882352941176471,3.6176470588235294,0.7714285714285715,10.828571428571431,13,-0.18319327731092439,-7.210924369747902,-22,0
2017,137,1413,62,1242,100,16,1,0.625,0.5,0.875,10.34375,15,-0.25,-9.84375,-38,0
2017,137,1297,70,1246,79,15,2,0.6875,3.03125,0.8529411764705882,14.352941176470589,13,-0.1654411764705882,-11.321691176470589,-9,0
2017,137,1240,63,1257,78,15,2,0.5625,0.875,0.75,11.6875,13,-0.1875,-10.8125,-15,0
2017,137,1329,91,1276,92,10,7,0.6129032258064516,7.225806451612903,0.6857142857142857,9.257142857142858,3,-0.0728110599078341,-2.031336405529955,-1,0
2017,137,1274,58,1277,78,8,9,0.65625,5.6875,0.5757575757575758,3.3636363636363638,-1,0.0804924242424242,2.3238636363636362,-20,0
2017,137,1411,64,1314,103,16,1,0.6764705882352942,2.588235294117648,0.7878787878787878,13.424242424242426,15,-0.11140819964349369,-10.836007130124777,-39,0
2017,137,1233,77,1332,93,14,3,0.6470588235294118,4.117647058823529,0.8484848484848485,13.303030303030303,11,-0.2014260249554367,-9.185383244206774,-16,0
2017,137,1166,72,1348,84,6,11,0.7272727272727273,8.93939393939394,0.7272727272727273,8.484848484848484,-5,0.0,0.45454545454545503,-12,0
2017,137,1266,73,1376,93,10,7,0.6129032258064516,7.516129032258065,0.6774193548387096,6.935483870967742,3,-0.06451612903225801,0.580645161290323,-20,0
2017,137,1245,80,1417,97,14,3,0.6176470588235294,3.088235294117648,0.8787878787878788,15.030303030303031,11,-0.26114081996434935,-11.942067736185383,-17,0
2017,137,1374,65,1425,66,6,11,0.8823529411764706,14.705882352941176,0.7272727272727273,5.515151515151516,-5,0.15508021390374327,9.19073083778966,-1,0
2017,137,1173,58,1455,64,7,10,0.7666666666666667,9.2,0.8787878787878788,19.303030303030305,-3,-0.11212121212121207,-10.103030303030305,-6,0
2017,138,1388,60,1112,69,7,2,0.875,15.5,0.8823529411764706,10.823529411764707,5,-0.007352941176470562,4.6764705882352935,-9,0
2017,138,1292,65,1139,74,12,4,0.8787878787878788,10.909090909090908,0.7419354838709677,7.903225806451613,8,0.13685239491691104,3.0058651026392953,-9,0
2017,138,1438,39,1196,65,5,4,0.6875,10.96875,0.75,11.71875,1,-0.0625,-0.75,-26,0
2017,138,1321,73,1211,79,8,1,0.6764705882352942,6.029411764705882,0.9696969696969697,23.424242424242426,7,-0.29322638146167557,-17.394830659536545,-6,0
2017,138,1235,76,1345,80,5,4,0.696969696969697,8.878787878787879,0.78125,12.96875,1,-0.08428030303030298,-4.089962121212121,-4,0
2017,138,1323,71,1452,83,5,4,0.7352941176470589,8.794117647058824,0.7647058823529411,15.647058823529411,1,-0.02941176470588225,-6.852941176470587,-12,0
2017,138,1437,62,1458,65,1,8,0.9117647058823529,14.882352941176471,0.7352941176470589,10.529411764705882,-7,0.17647058823529405,4.352941176470589,-3,0
2017,138,1199,66,1462,91,3,11,0.7575757575757576,11.18181818181818,0.6176470588235294,3.264705882352941,-8,0.13992869875222813,7.917112299465239,-25,0
2017,139,1425,78,1124,82,11,3,0.7272727272727273,5.515151515151516,0.7741935483870968,8.580645161290322,8,-0.04692082111436946,-3.0654936461388065,-4,0
2017,139,1277,70,1242,90,9,1,0.5757575757575758,3.3636363636363638,0.875,10.34375,8,-0.2992424242424242,-6.980113636363637,-20,0
2017,139,1455,62,1246,65,10,2,0.8787878787878788,19.303030303030305,0.8529411764705882,14.352941176470589,8,0.025846702317290582,4.950089126559716,-3,0
2017,139,1257,69,1276,73,2,7,0.75,11.6875,0.6857142857142857,9.257142857142858,-5,0.06428571428571428,2.430357142857142,-4,0
2017,139,1116,65,1314,72,8,1,0.7352941176470589,5.794117647058823,0.7878787878787878,13.424242424242426,7,-0.05258467023172897,-7.630124777183602,-7,0
2017,139,1348,72,1332,75,11,3,0.7272727272727273,8.484848484848484,0.8484848484848485,13.303030303030303,8,-0.12121212121212122,-4.818181818181818,-3,0
2017,139,1181,81,1376,88,2,7,0.7714285714285715,10.828571428571431,0.6774193548387096,6.935483870967742,-5,0.09400921658986183,3.893087557603689,-7,0
2017,139,1153,67,1417,79,6,3,0.8529411764705882,13.647058823529411,0.8787878787878788,15.030303030303031,3,-0.025846702317290582,-1.38324420677362,-12,0
2017,143,1452,58,1211,61,4,1,0.7647058823529411,15.647058823529411,0.9696969696969697,23.424242424242426,3,-0.2049910873440286,-7.777183600713014,-3,0
2017,143,1345,66,1242,98,4,1,0.78125,12.96875,0.875,10.34375,3,-0.09375,2.625,-32,0
2017,143,1276,68,1332,69,7,3,0.6857142857142857,9.257142857142858,0.8484848484848485,13.303030303030303,4,-0.1627705627705628,-4.045887445887445,-1,0
2017,143,1112,71,1462,73,2,11,0.8823529411764706,10.823529411764707,0.6176470588235294,3.264705882352941,-9,0.2647058823529411,7.558823529411765,-2,0
2017,144,1458,83,1196,84,8,4,0.7352941176470589,10.529411764705882,0.75,11.71875,4,-0.014705882352941124,-1.1893382352941178,-1,0
2017,144,1417,75,1246,86,3,2,0.8787878787878788,15.030303030303031,0.8529411764705882,14.352941176470589,1,0.025846702317290582,0.6773618538324424,-11,0
2017,144,1139,80,1314,92,4,1,0.7419354838709677,7.903225806451613,0.7878787878787878,13.424242424242426,3,-0.045943304007820096,-5.521016617790813,-12,0
2017,144,1124,50,1376,70,3,7,0.7741935483870968,8.580645161290322,0.6774193548387096,6.935483870967742,-4,0.09677419354838712,1.64516129032258,-20,0
2017,145,1462,59,1211,83,11,1,0.6176470588235294,3.264705882352941,0.9696969696969697,23.424242424242426,10,-0.3520499108734403,-20.159536541889484,-24,0
2017,145,1242,60,1332,74,1,3,0.875,10.34375,0.8484848484848485,13.303030303030303,-2,0.02651515151515149,-2.9592803030303028,-14,0
2017,146,1246,73,1314,75,2,1,0.8529411764705882,14.352941176470589,0.7878787878787878,13.424242424242426,1,0.06506238859180036,0.9286987522281631,-2,0
2017,146,1196,70,1376,77,4,7,0.75,11.71875,0.6774193548387096,6.935483870967742,-3,0.07258064516129037,4.783266129032258,-7,0
2017,152,1376,73,1211,77,7,1,0.6774193548387096,6.935483870967742,0.9696969696969697,23.424242424242426,6,-0.2922776148582601,-16.488758553274685,-4,0
2017,152,1332,76,1314,77,3,1,0.8484848484848485,13.303030303030303,0.7878787878787878,13.424242424242426,2,0.06060606060606066,-0.12121212121212288,-1,0
2017,154,1211,65,1314,71,1,1,0.9696969696969697,23.424242424242426,0.7878787878787878,13.424242424242426,0,0.18181818181818188,10.0,-6,0
2018,134,1254,61,1347,71,16,16,0.5151515151515151,-0.12121212121212122,0.625,2.0625,0,-0.10984848484848486,-2.183712121212121,-10,0
2018,134,1417,58,1382,65,11,11,0.65625,5.59375,0.78125,6.90625,0,-0.125,-1.3125,-7,0
2018,135,1113,56,1393,60,11,11,0.6451612903225806,8.193548387096774,0.6060606060606061,3.0,0,0.03910068426197455,5.193548387096774,-4,0
2018,135,1300,46,1411,64,16,16,0.5161290322580645,-0.3225806451612903,0.4411764705882353,-2.088235294117647,0,0.07495256166982922,1.765654648956357,-18,0
2018,136,1439,83,1104,86,8,9,0.65625,7.968750000000002,0.5588235294117647,2.3823529411764706,-1,0.09742647058823528,5.586397058823531,-3,0
2018,136,1112,68,1138,89,4,13,0.7941176470588235,9.705882352941176,0.7575757575757576,8.181818181818182,-9,0.036541889483065915,1.524064171122994,-21,0
2018,136,1233,67,1181,89,15,2,0.6060606060606061,3.696969696969697,0.7878787878787878,15.090909090909092,13,-0.18181818181818177,-11.393939393939394,-22,0
2018,136,1382,62,1196,77,11,6,0.78125,6.90625,0.625,6.625,5,0.15625,0.28125,-15,0
2018,136,1422,64,1211,68,13,4,0.7741935483870968,8.806451612903226,0.8823529411764706,17.38235294117647,9,-0.10815939278937381,-8.575901328273245,-4,0
2018,136,1361,65,1222,67,11,6,0.6774193548387096,8.64516129032258,0.7878787878787878,12.515151515151516,5,-0.11045943304007821,-3.8699902248289355,-2,0
2018,136,1335,60,1242,76,16,1,0.7419354838709677,6.096774193548387,0.7941176470588235,10.558823529411763,15,-0.052182163187855735,-4.462049335863376,-16,0
2018,136,1172,73,1246,78,12,5,0.65625,8.875,0.7058823529411765,6.4411764705882355,7,-0.049632352941176516,2.4338235294117645,-5,0
2018,136,1274,62,1260,64,6,11,0.7096774193548387,6.129032258064516,0.84375,9.65625,-5,-0.13407258064516125,-3.527217741935484,-2,0
2018,136,1285,47,1276,61,14,3,0.7741935483870968,9.258064516129032,0.7941176470588235,10.117647058823529,11,-0.01992409867172673,-0.859582542694497,-14,0
2018,136,1355,73,1326,81,12,5,0.8,7.733333333333333,0.75,9.125,7,0.050000000000000044,-1.3916666666666666,-8,0
2018,136,1328,78,1348,83,10,7,0.5806451612903226,3.5161290322580645,0.78125,8.28125,3,-0.20060483870967738,-4.765120967741936,-5,0
2018,136,1301,83,1371,94,9,8,0.65625,6.75,0.65625,5.6875,1,0.0,1.0625,-11,0
2018,136,1460,47,1397,73,14,3,0.71875,5.15625,0.7575757575757576,7.818181818181818,11,-0.03882575757575757,-2.6619318181818183,-26,0
2018,136,1372,60,1403,70,14,3,0.8,9.766666666666667,0.7272727272727273,10.545454545454545,11,0.07272727272727275,-0.7787878787878775,-10,0
2018,136,1347,61,1437,87,16,1,0.625,2.0625,0.8823529411764706,16.176470588235293,15,-0.25735294117647056,-14.113970588235293,-26,0
2018,137,1158,58,1120,62,13,4,0.7741935483870968,5.419354838709677,0.78125,10.0625,9,-0.007056451612903247,-4.643145161290323,-4,0
2018,137,1116,62,1139,79,7,10,0.6764705882352942,5.5588235294117645,0.6060606060606061,6.333333333333333,-3,0.07040998217468808,-0.7745098039215685,-17,0
2018,137,1209,53,1153,68,15,2,0.6875,6.65625,0.8823529411764706,17.323529411764707,13,-0.19485294117647056,-10.667279411764707,-15,0
2018,137,1308,68,1155,79,12,5,0.8333333333333334,10.866666666666667,0.71875,7.46875,7,0.11458333333333337,3.397916666666667,-11,0
2018,137,1281,54,1199,67,8,9,0.6129032258064516,5.193548387096774,0.6451612903225806,7.290322580645161,-1,-0.032258064516129004,-2.096774193548387,-13,0
2018,137,1166,59,1243,69,8,9,0.6451612903225806,8.838709677419354,0.6666666666666666,4.484848484848484,-1,-0.021505376344086002,4.35386119257087,-10,0
2018,137,1455,75,1267,81,4,13,0.78125,11.65625,0.696969696969697,4.515151515151516,-9,0.08428030303030298,7.141098484848484,-6,0
2018,137,1137,78,1277,82,14,3,0.7352941176470589,8.294117647058824,0.8787878787878788,16.181818181818183,11,-0.1434937611408199,-7.887700534759359,-4,0
2018,137,1400,83,1305,87,10,7,0.5757575757575758,3.5151515151515147,0.7941176470588235,10.205882352941176,3,-0.21836007130124768,-6.690730837789661,-4,0
2018,137,1252,66,1314,84,15,2,0.6896551724137931,2.3793103448275863,0.7142857142857143,8.857142857142858,13,-0.024630541871921152,-6.477832512315271,-18,0
2018,137,1168,48,1345,74,15,2,0.6206896551724138,1.0,0.8235294117647058,15.5,13,-0.20283975659229203,-14.5,-26,0
2018,137,1395,52,1393,57,6,11,0.65625,7.0625,0.6060606060606061,3.0,-5,0.05018939393939392,4.0625,-5,0
2018,137,1344,69,1401,73,10,7,0.6176470588235294,1.0294117647058822,0.625,5.1875,3,-0.007352941176470562,-4.158088235294118,-4,0
2018,137,1438,54,1420,74,1,16,0.9393939393939394,14.151515151515152,0.6774193548387096,1.5161290322580645,-15,0.2619745845552298,12.635386119257088,-20,0
2018,137,1293,68,1452,85,12,5,0.8275862068965517,11.344827586206897,0.7058823529411765,10.617647058823529,7,0.1217038539553752,0.7271805273833678,-17,0
2018,137,1411,83,1462,102,16,1,0.4411764705882353,-2.088235294117647,0.8484848484848485,9.787878787878787,15,-0.4073083778966132,-11.876114081996434,-19,0
2018,138,1348,62,1181,87,7,2,0.78125,8.28125,0.7878787878787878,15.090909090909092,5,-0.006628787878787845,-6.809659090909092,-25,0
2018,138,1326,84,1211,90,5,4,0.75,9.125,0.8823529411764706,17.38235294117647,1,-0.13235294117647056,-8.257352941176471,-6,0
2018,138,1371,79,1242,83,8,1,0.65625,5.6875,0.7941176470588235,10.558823529411763,7,-0.13786764705882348,-4.871323529411763,-4,0
2018,138,1138,75,1246,95,13,5,0.7575757575757576,8.181818181818182,0.7058823529411765,6.4411764705882355,8,0.05169340463458105,1.7406417112299462,-20,0
2018,138,1397,62,1260,63,3,11,0.7575757575757576,7.818181818181818,0.84375,9.65625,-8,-0.08617424242424243,-1.8380681818181817,-1,0
2018,138,1222,63,1276,64,6,3,0.7878787878787878,12.515151515151516,0.7941176470588235,10.117647058823529,3,-0.0062388591800356386,2.3975044563279866,-1,0
2018,138,1196,66,1403,69,6,3,0.625,6.625,0.7272727272727273,10.545454545454545,3,-0.10227272727272729,-3.920454545454545,-3,0
2018,138,1104,58,1437,81,9,1,0.5588235294117647,2.3823529411764706,0.8823529411764706,16.176470588235293,8,-0.32352941176470584,-13.794117647058822,-23,0
2018,139,1120,53,1155,84,4,5,0.78125,10.0625,0.71875,7.46875,-1,0.0625,2.59375,-31,0
2018,139,1462,70,1199,75,1,9,0.8484848484848485,9.787878787878787,0.6451612903225806,7.290322580645161,-8,0.20332355816226788,2.497556207233626,-5,0
2018,139,1420,43,1243,50,16,9,0.6774193548387096,1.5161290322580645,0.6666666666666666,4.484848484848484,7,0.010752688172043001,-2.96871945259042,-7,0
2018,139,1153,73,1305,75,2,7,0.8823529411764706,17.323529411764707,0.7941176470588235,10.205882352941176,-5,0.08823529411764708,7.117647058823531,-2,0
2018,139,1139,73,1345,76,10,2,0.6060606060606061,6.333333333333333,0.8235294117647058,15.5,8,-0.21746880570409977,-9.166666666666668,-3,0
2018,139,1277,53,1393,55,3,11,0.8787878787878788,16.181818181818183,0.6060606060606061,3.0,-8,0.2727272727272727,13.181818181818183,-2,0
2018,139,1314,65,1401,86,2,7,0.7142857142857143,8.857142857142858,0.625,5.1875,-5,0.0892857142857143,3.6696428571428577,-21,0
2018,139,1267,71,1452,94,13,5,0.696969696969697,4.515151515151516,0.7058823529411765,10.617647058823529,8,-0.0089126559714795,-6.102495543672013,-23,0
2018,143,1211,60,1199,75,4,9,0.8823529411764706,17.38235294117647,0.6451612903225806,7.290322580645161,-5,0.23719165085388993,10.09203036053131,-15,0
2018,143,1246,58,1243,61,5,9,0.7058823529411765,6.4411764705882355,0.6666666666666666,4.484848484848484,-4,0.03921568627450989,1.956327985739751,-3,0
2018,143,1305,68,1260,69,7,11,0.7941176470588235,10.205882352941176,0.84375,9.65625,-4,-0.049632352941176516,0.5496323529411757,-1,0
2018,143,1401,72,1276,99,7,3,0.625,5.1875,0.7941176470588235,10.117647058823529,4,-0.16911764705882348,-4.930147058823529,-27,0
2018,144,1393,65,1181,69,11,2,0.6060606060606061,3.0,0.7878787878787878,15.090909090909092,9,-0.18181818181818177,-12.090909090909092,-4,0
2018,144,1155,76,1242,80,5,1,0.71875,7.46875,0.7941176470588235,10.558823529411763,4,-0.07536764705882348,-3.0900735294117627,-4,0
2018,144,1345,65,1403,78,2,3,0.8235294117647058,15.5,0.7272727272727273,10.545454545454545,-1,0.09625668449197855,4.954545454545455,-13,0
2018,144,1452,78,1437,90,5,1,0.7058823529411765,10.617647058823529,0.8823529411764706,16.176470588235293,4,-0.17647058823529405,-5.5588235294117645,-12,0
2018,145,1243,62,1260,78,9,11,0.6666666666666666,4.484848484848484,0.84375,9.65625,-2,-0.17708333333333337,-5.171401515151516,-16,0
2018,145,1199,54,1276,58,9,3,0.6451612903225806,7.290322580645161,0.7941176470588235,10.117647058823529,6,-0.14895635673624286,-2.827324478178368,-4,0
2018,146,1181,81,1242,85,2,1,0.7878787878787878,15.090909090909092,0.7941176470588235,10.558823529411763,1,-0.0062388591800356386,4.532085561497329,-4,0
2018,146,1403,59,1437,71,3,1,0.7272727272727273,10.545454545454545,0.8823529411764706,16.176470588235293,2,-0.15508021390374327,-5.6310160427807485,-12,0
2018,152,1260,57,1276,69,11,3,0.84375,9.65625,0.7941176470588235,10.117647058823529,8,0.049632352941176516,-0.461397058823529,-12,0
2018,152,1242,79,1437,95,1,1,0.7941176470588235,10.558823529411763,0.8823529411764706,16.176470588235293,0,-0.08823529411764708,-5.617647058823531,-16,0
2018,154,1276,62,1437,79,3,1,0.7941176470588235,10.117647058823529,0.8823529411764706,16.176470588235293,2,-0.08823529411764708,-6.0588235294117645,-17,0
2019,134,1396,70,1125,81,11,11,0.71875,3.6875,0.8333333333333334,12.2,0,-0.11458333333333337,-8.5125,-11,0
2019,134,1341,76,1192,82,16,16,0.6363636363636364,2.121212121212121,0.5806451612903226,2.2580645161290325,0,0.055718475073313734,-0.13685239491691137,-6,0
2019,135,1385,65,1113,74,11,11,0.6363636363636364,2.727272727272727,0.6875,4.75,0,-0.051136363636363646,-2.022727272727273,-9,0
2019,135,1300,74,1295,78,16,16,0.5,-0.16666666666666666,0.5161290322580645,-1.4516129032258065,0,-0.016129032258064502,1.2849462365591398,-4,0
2019,136,1308,77,1120,78,12,5,0.875,12.84375,0.7352941176470589,10.294117647058824,7,0.13970588235294112,2.5496323529411757,-1,0
2019,136,1393,69,1124,78,8,9,0.6060606060606061,4.03030303030303,0.59375,4.46875,-1,0.012310606060606077,-0.4384469696969697,-9,0
2019,136,1305,61,1196,70,7,10,0.8787878787878788,14.0,0.5588235294117647,4.617647058823529,-3,0.31996434937611407,9.382352941176471,-9,0
2019,136,1436,69,1199,76,13,4,0.8125,9.5625,0.7941176470588235,7.794117647058823,9,0.018382352941176516,1.7683823529411766,-7,0
2019,136,1192,49,1211,87,16,1,0.5806451612903226,2.2580645161290325,0.9090909090909091,23.78787878787879,15,-0.32844574780058644,-21.529814271749757,-38,0
2019,136,1318,53,1242,87,13,4,0.696969696969697,5.818181818181818,0.7352941176470589,5.294117647058823,9,-0.03832442067736186,0.524064171122995,-34,0
2019,136,1101,44,1246,79,15,2,0.7931034482758621,6.827586206896552,0.8181818181818182,11.303030303030303,13,-0.025078369905956133,-4.475444096133751,-35,0
2019,136,1463,74,1261,79,14,3,0.75,7.178571428571429,0.8125,8.34375,11,-0.0625,-1.1651785714285712,-5,0
2019,136,1125,77,1268,79,11,6,0.8333333333333334,12.2,0.6875,6.28125,5,0.14583333333333337,5.918749999999999,-2,0
2019,136,1285,55,1276,74,15,2,0.75,7.34375,0.8235294117647058,11.823529411764708,13,-0.07352941176470584,-4.479779411764708,-19,0
2019,136,1133,65,1277,76,15,2,0.5757575757575758,1.181818181818181,0.8235294117647058,13.294117647058822,13,-0.24777183600713004,-12.11229946524064,-11,0
2019,136,1257,76,1278,86,7,10,0.6060606060606061,6.7272727272727275,0.6176470588235294,1.6176470588235294,-3,-0.01158645276292336,5.109625668449198,-10,0
2019,136,1266,64,1293,83,5,12,0.7272727272727273,8.636363636363637,0.8620689655172413,13.206896551724135,-7,-0.13479623824451403,-4.5705329153604985,-19,0
2019,136,1330,48,1345,61,14,3,0.7647058823529411,5.323529411764706,0.71875,9.375000000000002,11,0.045955882352941124,-4.051470588235296,-13,0
2019,136,1388,57,1437,61,11,6,0.6666666666666666,8.545454545454545,0.7352941176470589,7.382352941176471,5,-0.06862745098039225,1.163101604278074,-4,0
2019,136,1371,68,1459,84,10,7,0.6060606060606061,2.4545454545454546,0.8666666666666667,13.666666666666666,3,-0.2606060606060606,-11.212121212121211,-16,0
2019,137,1113,74,1138,91,11,6,0.6875,4.75,0.9090909090909091,13.818181818181818,5,-0.22159090909090906,-9.068181818181818,-17,0
2019,137,1295,62,1181,85,16,1,0.5161290322580645,-1.4516129032258065,0.8529411764705882,15.941176470588236,15,-0.3368121442125237,-17.392789373814043,-23,0
2019,137,1209,55,1222,84,14,3,0.71875,2.75,0.9117647058823529,14.382352941176473,11,-0.19301470588235292,-11.632352941176473,-29,0
2019,137,1153,72,1234,79,7,10,0.8235294117647058,9.5,0.6666666666666666,4.666666666666667,-3,0.1568627450980392,4.833333333333333,-7,0
2019,137,1280,76,1251,80,5,12,0.696969696969697,7.212121212121212,0.8064516129032258,9.903225806451612,-7,-0.10948191593352874,-2.6911045943304,-4,0
2019,137,1233,73,1314,88,16,1,0.53125,1.21875,0.8181818181818182,13.121212121212123,15,-0.28693181818181823,-11.902462121212123,-15,0
2019,137,1235,59,1326,62,6,11,0.6764705882352942,9.117647058823529,0.5757575757575758,3.4242424242424243,-5,0.10071301247771836,5.693404634581105,-3,0
2019,137,1279,72,1328,95,8,9,0.625,5.03125,0.59375,2.9375,-1,0.03125,2.09375,-23,0
2019,137,1458,54,1332,72,5,12,0.696969696969697,7.636363636363637,0.6571428571428571,7.542857142857143,-7,0.03982683982683988,0.09350649350649398,-18,0
2019,137,1159,70,1397,77,15,2,0.696969696969697,5.424242424242424,0.8484848484848485,12.181818181818182,13,-0.1515151515151515,-6.757575757575758,-7,0
2019,137,1297,57,1403,72,14,3,0.75,7.75,0.8125,13.8125,11,-0.0625,-6.0625,-15,0
2019,137,1243,64,1414,70,4,13,0.7575757575757576,6.575757575757576,0.8529411764705882,8.852941176470589,-9,-0.09536541889483063,-2.2771836007130126,-6,0
2019,137,1433,58,1416,73,8,9,0.78125,9.84375,0.7419354838709677,7.838709677419355,-1,0.03931451612903225,2.005040322580645,-15,0
2019,137,1205,56,1438,71,16,1,0.6451612903225806,2.3548387096774195,0.90625,16.78125,15,-0.2610887096774194,-14.42641129032258,-15,0
2019,137,1387,52,1439,66,13,4,0.6571428571428571,3.3142857142857136,0.75,11.90625,9,-0.09285714285714286,-8.591964285714287,-14,0
2019,137,1429,61,1449,78,8,9,0.8181818181818182,11.93939393939394,0.7647058823529411,5.4411764705882355,-1,0.05347593582887711,6.498217468805704,-17,0
2019,138,1242,75,1120,89,4,5,0.7352941176470589,5.294117647058823,0.7352941176470589,10.294117647058824,-1,0.0,-5.000000000000001,-14,0
2019,138,1293,62,1199,90,12,4,0.8620689655172413,13.206896551724135,0.7941176470588235,7.794117647058823,8,0.06795131845841784,5.412778904665312,-28,0
2019,138,1124,71,1211,83,9,1,0.59375,4.46875,0.9090909090909091,23.78787878787879,8,-0.31534090909090906,-19.31912878787879,-12,0
2019,138,1459,56,1246,62,7,2,0.8666666666666667,13.666666666666666,0.8181818181818182,11.303030303030303,5,0.048484848484848464,2.3636363636363633,-6,0
2019,138,1268,67,1261,69,6,3,0.6875,6.28125,0.8125,8.34375,3,-0.125,-2.0625,-2,0
2019,138,1196,49,1276,64,10,2,0.5588235294117647,4.617647058823529,0.8235294117647058,11.823529411764708,8,-0.2647058823529411,-7.205882352941179,-15,0
2019,138,1278,50,1277,70,10,2,0.6176470588235294,1.6176470588235294,0.8235294117647058,13.294117647058822,8,-0.2058823529411764,-11.676470588235293,-20,0
2019,138,1437,61,1345,87,6,3,0.7352941176470589,7.382352941176471,0.71875,9.375000000000002,3,0.016544117647058876,-1.9926470588235308,-26,0
2019,139,1416,76,1181,77,9,1,0.7419354838709677,7.838709677419355,0.8529411764705882,15.941176470588236,8,-0.11100569259962045,-8.10246679316888,-1,0
2019,139,1326,59,1222,74,11,3,0.5757575757575758,3.4242424242424243,0.9117647058823529,14.382352941176473,8,-0.3360071301247771,-10.958110516934049,-15,0
2019,139,1449,59,1314,81,9,1,0.7647058823529411,5.4411764705882355,0.8181818181818182,13.121212121212123,8,-0.05347593582887711,-7.680035650623887,-22,0
2019,139,1414,54,1332,73,13,12,0.8529411764705882,8.852941176470589,0.6571428571428571,7.542857142857143,1,0.19579831932773106,1.310084033613446,-19,0
2019,139,1234,77,1397,83,10,2,0.6666666666666666,4.666666666666667,0.8484848484848485,12.181818181818182,8,-0.18181818181818188,-7.515151515151515,-6,0
2019,139,1138,58,1403,78,6,3,0.9090909090909091,13.818181818181818,0.8125,13.8125,3,0.09659090909090906,0.005681818181818343,-20,0
2019,139,1328,51,1438,63,9,1,0.59375,2.9375,0.90625,16.78125,8,-0.3125,-13.84375,-12,0
2019,139,1251,58,1439,67,12,4,0.8064516129032258,9.903225806451612,0.75,11.90625,8,0.056451612903225756,-2.003024193548388,-9,0
2019,143,1199,58,1211,72,4,1,0.7941176470588235,7.794117647058823,0.9090909090909091,23.78787878787879,3,-0.11497326203208558,-15.993761140819966,-14,0
2019,143,1397,94,1345,99,2,3,0.8484848484848485,12.181818181818182,0.71875,9.375000000000002,-1,0.1297348484848485,2.80681818181818,-5,0
2019,143,1276,44,1403,63,2,3,0.8235294117647058,11.823529411764708,0.8125,13.8125,-1,0.011029411764705843,-1.9889705882352917,-19,0
2019,143,1332,49,1438,53,12,1,0.6571428571428571,7.542857142857143,0.90625,16.78125,11,-0.24910714285714286,-9.238392857142857,-4,0
2019,144,1314,80,1120,97,1,5,0.8181818181818182,13.121212121212123,0.7352941176470589,10.294117647058824,-4,0.08288770053475936,2.8270944741532986,-17,0
2019,144,1439,73,1181,75,4,1,0.75,11.90625,0.8529411764705882,15.941176470588236,3,-0.1029411764705882,-4.0349264705882355,-2,0
2019,144,1222,58,1246,62,3,2,0.9117647058823529,14.382352941176473,0.8181818181818182,11.303030303030303,1,0.09358288770053469,3.07932263814617,-4,0
2019,144,1261,63,1277,80,3,2,0.8125,8.34375,0.8235294117647058,13.294117647058822,1,-0.011029411764705843,-4.9503676470588225,-17,0
2019,145,1211,69,1403,75,1,3,0.9090909090909091,23.78787878787879,0.8125,13.8125,-2,0.09659090909090906,9.975378787878789,-6,0
2019,145,1345,75,1438,80,3,1,0.71875,9.375000000000002,0.90625,16.78125,2,-0.1875,-7.406249999999998,-5,0
2019,146,1246,71,1120,77,2,5,0.8181818181818182,11.303030303030303,0.7352941176470589,10.294117647058824,-3,0.08288770053475936,1.0089126559714785,-6,0
2019,146,1181,67,1277,68,1,2,0.8529411764705882,15.941176470588236,0.8235294117647058,13.294117647058822,-1,0.02941176470588236,2.647058823529413,-1,0
2019,152,1277,51,1403,61,2,3,0.8235294117647058,13.294117647058822,0.8125,13.8125,-1,0.011029411764705843,-0.5183823529411775,-10,0
2019,152,1120,62,1438,63,5,1,0.7352941176470589,10.294117647058824,0.90625,16.78125,4,-0.17095588235294112,-6.487132352941176,-1,0
2019,154,1403,77,1438,85,3,1,0.8125,13.8125,0.90625,16.78125,2,-0.09375,-2.96875,-8,0
2021,136,1455,52,1179,53,11,11,0.7368421052631579,2.6315789473684212,0.8518518518518519,11.185185185185185,0,-0.115009746588694,-8.553606237816764,-1,0
2021,136,1111,53,1313,54,16,16,0.5416666666666666,-0.08333333333333275,0.6666666666666666,4.571428571428571,0,-0.125,-4.654761904761904,-1,0
2021,136,1291,52,1411,60,16,16,0.5454545454545454,1.4090909090909092,0.6521739130434783,3.4782608695652173,0,-0.10671936758893286,-2.069169960474308,-8,0
2021,136,1277,80,1417,86,11,11,0.5555555555555556,-1.5185185185185186,0.6538461538461539,4.346153846153846,0,-0.09829059829059827,-5.864672364672364,-6,0
2021,137,1159,68,1116,85,14,3,0.9333333333333333,17.733333333333334,0.7857142857142857,11.714285714285714,11,0.14761904761904765,6.019047619047621,-17,0
2021,137,1216,55,1124,79,16,1,0.6521739130434783,2.608695652173913,0.9166666666666666,17.958333333333332,15,-0.26449275362318836,-15.349637681159418,-24,0
2021,137,1439,70,1196,75,10,7,0.7142857142857143,6.619047619047619,0.6086956521739131,4.130434782608695,3,0.10559006211180122,2.4886128364389233,-5,0
2021,137,1156,56,1222,87,15,2,0.7307692307692307,0.8846153846153846,0.8846153846153846,18.0,13,-0.15384615384615385,-17.115384615384617,-31,0
2021,137,1180,49,1228,78,16,1,0.631578947368421,4.631578947368421,0.7931034482758621,12.172413793103448,15,-0.16152450090744108,-7.540834845735027,-29,0
2021,137,1210,60,1260,71,9,8,0.68,5.52,0.8461538461538461,14.692307692307692,1,-0.1661538461538461,-9.172307692307692,-11,0
2021,137,1345,69,1317,78,4,13,0.6666666666666666,4.814814814814815,0.64,7.64,-9,0.026666666666666616,-2.825185185185185,-9,0
2021,137,1251,60,1329,69,13,4,0.7916666666666666,11.0,0.7142857142857143,4.178571428571429,9,0.07738095238095233,6.821428571428571,-9,0
2021,137,1326,72,1331,75,2,15,0.7,6.366666666666666,0.5652173913043478,1.826086956521739,-13,0.13478260869565217,4.540579710144927,-3,0
2021,137,1397,56,1333,70,5,12,0.6923076923076923,9.26923076923077,0.5714285714285714,-0.14285714285714285,-7,0.1208791208791209,9.412087912087912,-14,0
2021,137,1155,56,1353,60,7,10,0.6956521739130435,3.3043478260869565,0.5769230769230769,1.7307692307692308,-3,0.11872909698996659,1.5735785953177257,-4,0
2021,137,1361,62,1393,78,6,11,0.8461538461538461,12.423076923076923,0.64,5.12,-5,0.20615384615384613,7.303076923076923,-16,0
2021,137,1429,53,1403,65,11,6,0.7037037037037037,10.481481481481481,0.6296296296296297,9.62962962962963,5,0.07407407407407407,0.8518518518518512,-12,0
2021,137,1457,63,1437,73,12,5,0.9583333333333334,12.75,0.7272727272727273,8.409090909090908,7,0.23106060606060608,4.340909090909092,-10,0
2021,137,1287,67,1452,84,14,3,0.75,4.107142857142857,0.6666666666666666,5.185185185185185,11,0.08333333333333337,-1.0780423280423284,-17,0
2021,137,1314,62,1458,85,8,9,0.6428571428571429,6.285714285714286,0.5862068965517241,5.310344827586207,-1,0.05665024630541882,0.9753694581280783,-23,0
2021,138,1400,52,1101,53,3,14,0.7307692307692307,6.423076923076923,0.8260869565217391,14.565217391304348,-11,-0.09531772575250841,-8.142140468227424,-1,0
2021,138,1233,55,1104,68,15,2,0.7058823529411765,6.294117647058823,0.8,9.8,13,-0.09411764705882353,-3.5058823529411773,-13,0
2021,138,1207,73,1160,96,12,5,0.52,0.68,0.7333333333333333,9.766666666666667,7,-0.21333333333333326,-9.086666666666668,-23,0
2021,138,1364,62,1166,63,12,5,0.8333333333333334,10.333333333333334,0.7142857142857143,8.678571428571429,7,0.11904761904761907,1.654761904761905,-1,0
2021,138,1422,54,1199,64,13,4,0.7241379310344828,6.172413793103448,0.7272727272727273,8.590909090909092,9,-0.0031347962382445305,-2.4184952978056433,-10,0
2021,138,1313,55,1211,98,16,1,0.6666666666666666,4.571428571428571,1.0,23.0,15,-0.33333333333333337,-18.42857142857143,-43,0
2021,138,1213,74,1234,86,15,2,0.7,9.6,0.7241379310344828,11.827586206896552,13,-0.024137931034482807,-2.227586206896552,-12,0
2021,138,1186,84,1242,93,14,3,0.6818181818181818,7.909090909090909,0.7037037037037037,6.333333333333333,11,-0.021885521885521952,1.5757575757575761,-9,0
2021,138,1382,61,1261,76,9,8,0.8,10.15,0.6666666666666666,6.777777777777778,1,0.13333333333333341,3.3722222222222227,-15,0
2021,138,1163,54,1268,63,7,10,0.6818181818181818,7.909090909090909,0.5357142857142857,2.4642857142857144,-3,0.14610389610389607,5.444805194805195,-9,0
2021,138,1411,66,1276,82,16,1,0.6521739130434783,3.4782608695652173,0.8333333333333334,10.875,15,-0.1811594202898551,-7.396739130434783,-16,0
2021,138,1438,58,1325,62,4,13,0.75,8.166666666666666,0.6818181818181818,7.045454545454544,-9,0.06818181818181823,1.121212121212122,-4,0
2021,138,1281,68,1328,72,9,8,0.64,1.72,0.6,5.52,1,0.040000000000000036,-3.8,-4,0
2021,138,1140,62,1417,73,6,11,0.76,8.72,0.6538461538461539,4.346153846153846,-5,0.10615384615384615,4.373846153846155,-11,0
2021,138,1179,56,1425,72,11,6,0.8518518518518519,11.185185185185185,0.7586206896551724,9.655172413793103,5,0.09323116219667948,1.530012771392082,-16,0
2021,139,1403,66,1116,68,6,3,0.6296296296296297,9.62962962962963,0.7857142857142857,11.714285714285714,3,-0.15608465608465605,-2.0846560846560838,-2,0
2021,139,1458,63,1124,76,9,1,0.5862068965517241,5.310344827586207,0.9166666666666666,17.958333333333332,8,-0.33045977011494254,-12.647988505747126,-13,0
2021,139,1353,60,1222,63,10,2,0.5769230769230769,1.7307692307692308,0.8846153846153846,18.0,8,-0.3076923076923077,-16.26923076923077,-3,0
2021,139,1228,58,1260,71,1,8,0.7931034482758621,12.172413793103448,0.8461538461538461,14.692307692307692,-7,-0.053050397877984046,-2.5198938992042432,-13,0
2021,139,1196,78,1331,81,7,15,0.6086956521739131,4.130434782608695,0.5652173913043478,1.826086956521739,-8,0.0434782608695653,2.304347826086956,-3,0
2021,139,1329,70,1333,80,4,12,0.7142857142857143,4.178571428571429,0.5714285714285714,-0.14285714285714285,-8,0.1428571428571429,4.321428571428572,-10,0
2021,139,1452,72,1393,75,3,11,0.6666666666666666,5.185185185185185,0.64,5.12,-8,0.026666666666666616,0.06518518518518501,-3,0
2021,139,1317,61,1437,84,13,5,0.64,7.64,0.7272727272727273,8.409090909090908,8,-0.08727272727272728,-0.7690909090909086,-23,0
2021,140,1268,77,1104,96,10,2,0.5357142857142857,2.4642857142857144,0.8,9.8,8,-0.26428571428571435,-7.335714285714286,-19,0
2021,140,1325,58,1166,72,13,5,0.6818181818181818,7.045454545454544,0.7142857142857143,8.678571428571429,8,-0.032467532467532534,-1.6331168831168847,-14,0
2021,140,1160,53,1199,71,5,4,0.7333333333333333,9.766666666666667,0.7272727272727273,8.590909090909092,1,0.006060606060605989,1.1757575757575758,-18,0
2021,140,1328,71,1211,87,8,1,0.6,5.52,1.0,23.0,7,-0.4,-17.48,-16,0
2021,140,1261,78,1276,86,8,1,0.6666666666666666,6.777777777777778,0.8333333333333334,10.875,7,-0.16666666666666674,-4.097222222222222,-8,0
2021,140,1234,80,1332,95,2,7,0.7241379310344828,11.827586206896552,0.7692307692307693,6.961538461538462,-5,-0.04509283819628651,4.86604774535809,-15,0
2021,140,1101,47,1417,67,14,11,0.8260869565217391,14.565217391304348,0.6538461538461539,4.346153846153846,3,0.17224080267558528,10.219063545150501,-20,0
2021,140,1242,51,1425,85,3,6,0.7037037037037037,6.333333333333333,0.7586206896551724,9.655172413793103,-3,-0.054916985951468655,-3.32183908045977,-34,0
2021,145,1331,70,1116,72,15,3,0.5652173913043478,1.826086956521739,0.7857142857142857,11.714285714285714,12,-0.22049689440993792,-9.888198757763975,-2,0
2021,145,1437,51,1124,62,5,1,0.7272727272727273,8.409090909090908,0.9166666666666666,17.958333333333332,4,-0.18939393939393934,-9.549242424242424,-11,0
2021,145,1393,46,1222,62,11,2,0.64,5.12,0.8846153846153846,18.0,9,-0.24461538461538457,-12.879999999999999,-16,0
2021,145,1260,58,1333,65,8,12,0.8461538461538461,14.692307692307692,0.5714285714285714,-0.14285714285714285,-4,0.27472527472527475,14.835164835164834,-7,0
2021,146,1166,65,1211,83,5,1,0.7142857142857143,8.678571428571429,1.0,23.0,4,-0.2857142857142857,-14.321428571428571,-18,0
2021,146,1199,58,1276,76,4,1,0.7272727272727273,8.590909090909092,0.8333333333333334,10.875,3,-0.10606060606060608,-2.2840909090909083,-18,0
2021,146,1104,78,1417,88,2,11,0.8,9.8,0.6538461538461539,4.346153846153846,-9,0.1461538461538462,5.453846153846155,-10,0
2021,146,1332,68,1425,82,7,6,0.7692307692307693,6.961538461538462,0.7586206896551724,9.655172413793103,1,0.010610079575596898,-2.6936339522546415,-14,0
2021,147,1116,72,1124,81,3,1,0.7857142857142857,11.714285714285714,0.9166666666666666,17.958333333333332,2,-0.13095238095238093,-6.244047619047619,-9,0
2021,147,1333,61,1222,67,12,2,0.5714285714285714,-0.14285714285714285,0.8846153846153846,18.0,10,-0.3131868131868132,-18.142857142857142,-6,0
2021,148,1425,66,1211,85,6,1,0.7586206896551724,9.655172413793103,1.0,23.0,5,-0.24137931034482762,-13.344827586206897,-19,0
2021,148,1276,49,1417,51,1,11,0.8333333333333334,10.875,0.6538461538461539,4.346153846153846,-10,0.17948717948717952,6.528846153846154,-2,0
2021,152,1222,59,1124,78,2,1,0.8846153846153846,18.0,0.9166666666666666,17.958333333333332,1,-0.03205128205128205,0.04166666666666785,-19,0
2021,152,1417,90,1211,93,11,1,0.6538461538461539,4.346153846153846,1.0,23.0,10,-0.34615384615384615,-18.653846153846153,-3,0
2021,154,1211,70,1124,86,1,1,1.0,23.0,0.9166666666666666,17.958333333333332,0,0.08333333333333337,5.041666666666668,-16,0
2022,134,1461,58,1231,66,12,12,0.75,6.1875,0.6060606060606061,5.545454545454546,0,0.14393939393939392,0.6420454545454541,-8,0
2022,134,1394,67,1411,76,16,16,0.6333333333333333,2.7000000000000006,0.6,3.7333333333333334,0,0.033333333333333326,-1.0333333333333328,-9,0
2022,135,1353,87,1323,89,11,11,0.5806451612903226,2.0967741935483866,0.6774193548387096,5.0,0,-0.09677419354838701,-2.9032258064516134,-2,0
2022,135,1136,82,1460,93,16,16,0.7,3.0666666666666655,0.6060606060606061,3.5454545454545454,0,0.09393939393939388,-0.4787878787878799,-11,0
2022,136,1436,71,1116,75,13,4,0.84375,14.062500000000002,0.7575757575757576,8.393939393939394,9,0.08617424242424243,5.668560606060607,-4,0
2022,136,1313,49,1124,85,16,1,0.7777777777777778,6.925925925925926,0.8125,12.875,15,-0.03472222222222221,-5.949074074074074,-36,0
2022,136,1361,69,1166,72,8,9,0.7419354838709677,7.612903225806452,0.6666666666666666,3.090909090909091,-1,0.07526881720430112,4.521994134897361,-3,0
2022,136,1209,72,1211,93,16,1,0.6,1.08,0.896551724137931,22.482758620689655,15,-0.29655172413793107,-21.402758620689653,-21,0
2022,136,1411,56,1242,83,16,1,0.6,3.7333333333333334,0.8235294117647058,10.441176470588236,15,-0.22352941176470587,-6.707843137254902,-27,0
2022,136,1129,53,1272,64,8,9,0.7878787878787878,7.242424242424242,0.6774193548387096,7.032258064516129,-1,0.11045943304007821,0.2101661779081132,-11,0
2022,136,1161,63,1276,75,6,11,0.8275862068965517,7.379310344827586,0.5483870967741935,3.161290322580645,-5,0.2791991101223582,4.218020022246941,-12,0
2022,136,1362,87,1293,92,10,7,0.71875,9.3125,0.9310344827586207,14.0,3,-0.21228448275862066,-4.6875,-5,0
2022,136,1163,63,1308,70,5,12,0.71875,10.03125,0.7931034482758621,6.206896551724138,-7,-0.0743534482758621,3.824353448275862,-7,0
2022,136,1266,63,1314,95,9,8,0.6129032258064516,3.5161290322580645,0.7272727272727273,5.787878787878788,1,-0.11436950146627567,-2.2717497556207236,-32,0
2022,136,1355,57,1344,66,13,4,0.875,10.96875,0.8333333333333334,4.799999999999999,9,0.04166666666666663,6.168750000000001,-9,0
2022,136,1234,63,1350,67,5,12,0.7428571428571429,12.485714285714286,0.6571428571428571,3.4285714285714284,-7,0.08571428571428574,9.057142857142857,-4,0
2022,136,1231,53,1388,82,12,5,0.6060606060606061,5.545454545454546,0.7741935483870968,8.35483870967742,7,-0.16813294232649068,-2.809384164222874,-29,0
2022,136,1246,79,1389,85,2,15,0.7878787878787878,13.454545454545455,0.6206896551724138,3.9310344827586206,-13,0.16718913270637403,9.523510971786834,-6,0
2022,136,1255,56,1397,88,14,3,0.7857142857142857,7.178571428571429,0.7878787878787878,10.424242424242424,11,-0.0021645021645021467,-3.245670995670995,-32,0
2022,136,1103,53,1417,57,13,4,0.7096774193548387,5.129032258064516,0.78125,11.5625,9,-0.07157258064516125,-6.433467741935484,-4,0
2022,137,1460,70,1112,87,16,1,0.6060606060606061,3.5454545454545454,0.9117647058823529,17.029411764705884,15,-0.30570409982174684,-13.483957219251339,-17,0
2022,137,1240,61,1120,80,15,2,0.6551724137931034,4.379310344827586,0.84375,11.6875,13,-0.18857758620689657,-7.308189655172414,-19,0
2022,137,1168,61,1181,78,15,2,0.6551724137931034,2.896551724137931,0.8235294117647058,13.029411764705882,13,-0.16835699797160242,-10.132860040567952,-17,0
2022,137,1412,68,1222,82,12,5,0.78125,11.8125,0.8529411764705882,16.941176470588236,7,-0.0716911764705882,-5.1286764705882355,-14,0
2022,137,1151,53,1228,54,13,4,0.78125,7.3125,0.7096774193548387,8.129032258064516,9,0.07157258064516125,-0.816532258064516,-1,0
2022,137,1261,54,1235,59,6,11,0.6666666666666666,9.575757575757576,0.625,3.46875,-5,0.04166666666666663,6.107007575757576,-5,0
2022,137,1425,66,1274,68,7,10,0.7878787878787878,6.666666666666667,0.696969696969697,3.787878787878789,-3,0.09090909090909083,2.878787878787878,-2,0
2022,137,1172,73,1277,74,10,7,0.8125,8.8125,0.6470588235294118,3.6470588235294117,3,0.1654411764705882,5.165441176470589,-1,0
2022,137,1104,64,1323,78,6,11,0.59375,3.5625,0.6774193548387096,5.0,-5,-0.08366935483870963,-1.4375,-14,0
2022,137,1260,41,1326,54,10,7,0.7741935483870968,11.225806451612904,0.6333333333333333,5.333333333333333,3,0.14086021505376345,5.892473118279571,-13,0
2022,137,1463,56,1345,78,14,3,0.6206896551724138,2.0344827586206895,0.7941176470588235,11.029411764705882,11,-0.17342799188640967,-8.994929006085194,-22,0
2022,137,1371,42,1395,69,8,9,0.6666666666666666,5.266666666666667,0.625,3.09375,-1,0.04166666666666663,2.1729166666666666,-27,0
2022,137,1439,73,1400,81,11,6,0.6571428571428571,8.457142857142857,0.65625,8.71875,5,0.0008928571428571397,-0.2616071428571427,-8,0
2022,137,1286,62,1403,97,14,3,0.78125,6.531249999999999,0.7352941176470589,11.382352941176471,11,0.045955882352941124,-4.851102941176472,-35,0
2022,137,1174,60,1437,80,15,2,0.6363636363636364,2.8181818181818183,0.7878787878787878,9.545454545454545,13,-0.1515151515151515,-6.727272727272727,-20,0
2022,137,1159,60,1458,67,14,3,0.6666666666666666,7.787878787878788,0.7741935483870968,4.161290322580645,11,-0.10752688172043012,3.626588465298143,-7,0
2022,138,1308,48,1116,53,12,4,0.7931034482758621,6.206896551724138,0.7575757575757576,8.393939393939394,8,0.03552769070010453,-2.1870428422152566,-5,0
2022,138,1272,78,1211,82,9,1,0.6774193548387096,7.032258064516129,0.896551724137931,22.482758620689655,8,-0.21913236929922142,-15.450500556173527,-4,0
2022,138,1166,72,1242,79,9,1,0.6666666666666666,3.090909090909091,0.8235294117647058,10.441176470588236,8,-0.1568627450980392,-7.350267379679145,-7,0
2022,138,1397,68,1276,76,3,11,0.7878787878787878,10.424242424242424,0.5483870967741935,3.161290322580645,-8,0.23949169110459434,7.262952101661779,-8,0
2022,138,1124,86,1314,93,1,8,0.8125,12.875,0.7272727272727273,5.787878787878788,-7,0.08522727272727271,7.087121212121212,-7,0
2022,138,1350,51,1344,79,12,4,0.6571428571428571,3.4285714285714284,0.8333333333333334,4.799999999999999,8,-0.17619047619047623,-1.3714285714285706,-28,0
2022,138,1293,60,1389,70,7,15,0.9310344827586207,14.0,0.6206896551724138,3.9310344827586206,-8,0.31034482758620685,10.068965517241379,-10,0
2022,138,1388,56,1417,72,5,4,0.7741935483870968,8.35483870967742,0.78125,11.5625,1,-0.007056451612903247,-3.20766129032258,-16,0
2022,139,1395,80,1112,85,9,1,0.625,3.09375,0.9117647058823529,17.029411764705884,8,-0.2867647058823529,-13.935661764705884,-5,0
2022,139,1277,76,1181,85,7,2,0.6470588235294118,3.6470588235294117,0.8235294117647058,13.029411764705882,5,-0.17647058823529405,-9.382352941176471,-9,0
2022,139,1228,53,1222,68,4,5,0.7096774193548387,8.129032258064516,0.8529411764705882,16.941176470588236,-1,-0.14326375711574946,-8.81214421252372,-15,0
2022,139,1458,49,1235,54,3,11,0.7741935483870968,4.161290322580645,0.625,3.46875,-8,0.14919354838709675,0.692540322580645,-5,0
2022,139,1120,61,1274,79,2,10,0.84375,11.6875,0.696969696969697,3.787878787878789,-8,0.14678030303030298,7.899621212121211,-18,0
2022,139,1400,71,1345,81,6,3,0.65625,8.71875,0.7941176470588235,11.029411764705882,3,-0.13786764705882348,-2.3106617647058822,-10,0
2022,139,1323,53,1403,59,11,3,0.6774193548387096,5.0,0.7352941176470589,11.382352941176471,8,-0.057874762808349245,-6.382352941176471,-6,0
2022,139,1326,61,1437,71,7,2,0.6333333333333333,5.333333333333333,0.7878787878787878,9.545454545454545,5,-0.15454545454545454,-4.212121212121212,-10,0
2022,143,1211,68,1116,74,1,4,0.896551724137931,22.482758620689655,0.7575757575757576,8.393939393939394,-3,0.13897596656217348,14.08881922675026,-6,0
2022,143,1403,73,1181,78,3,2,0.7352941176470589,11.382352941176471,0.8235294117647058,13.029411764705882,1,-0.08823529411764697,-1.6470588235294112,-5,0
2022,143,1112,60,1222,72,1,5,0.9117647058823529,17.029411764705884,0.8529411764705882,16.941176470588236,-4,0.05882352941176472,0.08823529411764852,-12,0
2022,143,1276,55,1437,63,11,2,0.5483870967741935,3.161290322580645,0.7878787878787878,9.545454545454545,9,-0.23949169110459434,-6.3841642228739,-8,0
2022,144,1344,61,1242,66,4,1,0.8333333333333334,4.799999999999999,0.8235294117647058,10.441176470588236,3,0.009803921568627527,-5.641176470588237,-5,0
2022,144,1235,56,1274,70,11,10,0.625,3.46875,0.696969696969697,3.787878787878789,1,-0.07196969696969702,-0.31912878787878896,-14,0
2022,144,1417,66,1314,73,4,8,0.78125,11.5625,0.7272727272727273,5.787878787878788,-4,0.05397727272727271,5.774621212121212,-7,0
2022,144,1345,64,1389,67,3,15,0.7941176470588235,11.029411764705882,0.6206896551724138,3.9310344827586206,-12,0.17342799188640967,7.098377281947261,-3,0
2022,145,1116,69,1181,78,4,2,0.7575757575757576,8.393939393939394,0.8235294117647058,13.029411764705882,2,-0.06595365418894827,-4.635472370766488,-9,0
2022,145,1222,44,1437,50,5,2,0.8529411764705882,16.941176470588236,0.7878787878787878,9.545454545454545,3,0.06506238859180036,7.3957219251336905,-6,0
2022,146,1274,50,1242,76,10,1,0.696969696969697,3.787878787878789,0.8235294117647058,10.441176470588236,9,-0.12655971479500883,-6.6532976827094465,-26,0
2022,146,1389,49,1314,69,15,8,0.6206896551724138,3.9310344827586206,0.7272727272727273,5.787878787878788,7,-0.10658307210031348,-1.8568443051201675,-20,0
2022,152,1437,65,1242,81,2,1,0.7878787878787878,9.545454545454545,0.8235294117647058,10.441176470588236,1,-0.035650623885918,-0.8957219251336905,-16,0
2022,152,1181,77,1314,81,2,8,0.8235294117647058,13.029411764705882,0.7272727272727273,5.787878787878788,-6,0.09625668449197855,7.241532976827094,-4,0
2022,154,1314,69,1242,72,8,1,0.7272727272727273,5.787878787878788,0.8235294117647058,10.441176470588236,7,-0.09625668449197855,-4.653297682709447,-3,0
